hoa hoa_mào_gà True	hypernym
hồng máy_tính_xách_tay False	Random
cây_cà_phê cây_rau False	co-hypernym
tranh tranh_khắc_gỗ True	hypernym
bút_lông đậu_đũa False	Random
cá_biển cá_chim False	co-hypernym
ngoan ngoan_hiền True	hypernym
cây_thuốc cây_phi_lao False	Random
viêm_xoang ốm_vặt False	co-hypernym
cây cây_cà_phê True	hypernym
âm_mưu chim_hồng_hạc False	Random
ghế_xôpha ghế_băng False	co-hypernym
thịt thịt_chó True	hypernym
chả_rán gà_mái_tơ False	Random
chim_cút chim_kền_kền False	co-hypernym
bò bò_rừng_bizon True	hypernym
nước thịt_vai False	Random
nấm hẹ False	co-hypernym
cá cá_chuối True	hypernym
bắp_cải nhạc_dân_gian False	Random
cây_cà_phê cây_xoan False	co-hypernym
rắn rắn_hổ_mang True	hypernym
nấm_kim_châm su_su False	Random
cá_chiên cá_trắm False	co-hypernym
kiến kiến_lửa True	hypernym
chó hồ_điệp False	Random
dưa_hấu nho False	co-hypernym
rau cần_tây True	hypernym
phim_điện_ảnh thịt_lợn False	Random
lá_nốt sả False	co-hypernym
bò bò_zebu True	hypernym
ghế ho_gà False	Random
cá_chình cá_mập False	co-hypernym
cây cây_ăn_quả True	hypernym
chổi_xể cây_công_nghiệp False	Random
cây_gỗ cây_lương_thực False	co-hypernym
bút bút_lông True	hypernym
cây_chuối_mỏ_phượng xoài False	Random
tủ_tài_liệu tủ_bảo_ôn False	co-hypernym
bút bút_mực True	hypernym
tranh_tường tàu_hỏa False	Random
tiểu_học trường_tiểu_học False	co-hypernym
tranh tranh_sơn_dầu True	hypernym
ghế_vải âm_vị False	Random
cà_rốt xu_hào False	co-hypernym
bệnh bệnh_thận True	hypernym
gương_cầu_lõm dép_quai_hậu False	Random
ghế_mềm ghế_mây False	co-hypernym
nước nước_mặn True	hypernym
học chổi False	Random
sự_uỷ_thác sự_giao_phó False	co-hypernym
nước nước_khoáng True	hypernym
gà_công_nghiệp nhạc_sống False	Random
mơ mận False	co-hypernym
tranh tranh_minh_hoạ True	hypernym
bò_biển cây_xương_rồng False	Random
bí_đao khổ_qua False	co-hypernym
cây cây_bưởi True	hypernym
cây_lâu_năm hoa_lan False	Random
trường_cao_đẳng đại_học False	co-hypernym
cây cây_lấy_gỗ True	hypernym
đèn_chùm chim_cút False	Random
hoa_tuylip hoa_phong_lan False	co-hypernym
Cá cá_voi True	hypernym
cây_keo xà_lách False	Random
tiếng_nhạc âm_vị False	co-hypernym
cá cá_quả True	hypernym
tủ_đông đèn_hình False	Random
cây_lan cây_rau False	co-hypernym
tủ tủ_bảo_ôn True	hypernym
mận cung_ứng False	Random
rau_muống bạc_hà False	co-hypernym
Mưa mưa_đá True	hypernym
cá_da_trơn tranh_tết False	Random
sầu_riêng dứa False	co-hypernym
tháng tháng_hai True	hypernym
giường_thất_bảo táo False	Random
đậu_hà_lan rau_muống False	co-hypernym
hoa hoa_địa_lan True	hypernym
bếp_gas mưu_đồ False	Random
thương_hàn bệnh_cảm_cúm False	co-hypernym
hoa hoa_hồng_bạch True	hypernym
hoa_tầm_xuân gà False	Random
gà_tơ gà_tây False	co-hypernym
cá cá_nhám True	hypernym
kính hạt_mít False	Random
trăn hổ False	co-hypernym
gạch gạch_ngói True	hypernym
xe_thồ đèn_chùm False	Random
cây_leo cây_hoa False	co-hypernym
gạch gạch_hoa True	hypernym
hoa_súng tiền_giấy False	Random
bí_đao đậu_đũa False	co-hypernym
bệnh bệnh_kí_sinh_trùng True	hypernym
quạt_giấy lan_vũ_nữ False	Random
bột_cà_ri tương_ớt False	co-hypernym
tủ tủ_lạnh True	hypernym
nhãn mù_tạt False	Random
đèn_chiếu_sáng đèn_dầu False	co-hypernym
rắn rắn_mối True	hypernym
chuối_ngự đèn_chùm False	Random
tỏi nước_mắm False	co-hypernym
chim chim_biển True	hypernym
lúa_mì nhạc_đỏ False	Random
bệnh_cảm_cúm bệnh_nặng False	co-hypernym
chim chim_sẻ True	hypernym
chim_chích_chòe chó_sói False	Random
cá_nóc cá_ngừ False	co-hypernym
chim bồ_câu True	hypernym
hoa_súng bàn False	Random
cây_bụi cây_leo False	co-hypernym
đèn đèn_cao_áp True	hypernym
ghế_tựa thừa_nhận False	Random
bếp_nướng bếp_trấu False	co-hypernym
đèn đèn_pin True	hypernym
bàn_học hoa_giấy False	Random
củ_cải_trắng xà_lách False	co-hypernym
cây_lương_thực sắn True	hypernym
hoa_phong_lan đường_phèn False	Random
cây_sung cây_xanh False	co-hypernym
vịt vịt_mòng_két_mày_trắng True	hypernym
tía_tô lê False	Random
hoa_tuylip hoa_lau False	co-hypernym
cây_lương_thực lúa_nước True	hypernym
lý lựu False	Random
bò_nái bò_bizon False	co-hypernym
bánh bánh_trưng True	hypernym
dưa_hồng chả_cua False	Random
nước_ngọt nước_suối False	co-hypernym
bánh bánh_giày True	hypernym
nhạc_vàng dứa False	Random
giá hẹ False	co-hypernym
tiền tiền_polime True	hypernym
tủ_bảo_hiểm tiếng_ồn False	Random
cá_trê cá_sấu False	co-hypernym
rau hành_tây True	hypernym
nhạc_tài_tử hoa_cẩm_tú_cầu False	Random
khế mận False	co-hypernym
rau mồng_tơi True	hypernym
tàu bò_tơ False	Random
cây_cọ cây_lúa False	co-hypernym
rau cải_bắp True	hypernym
lịch_sử rau_dền False	Random
hoa_hướng_dương hoa_huệ False	co-hypernym
rau cải_thìa True	hypernym
đàn thịt_gà False	Random
đậu_đũa rau_muống False	co-hypernym
tủ tủ_kính True	hypernym
tâm_lý_học lan_vũ_nữ False	Random
kiết_lị bệnh_da_ngoài_da False	co-hypernym
đèn đèn_điện True	hypernym
củ_năng tranh_sơn_dầu False	Random
hoa_bách_hợp hoa_sen False	co-hypernym
ghế ghế_gấp True	hypernym
tóc_đen lúa_nước False	Random
sự_uỷ_thác sự_uỷ_nhiệm False	co-hypernym
nấm nấm_rơm True	hypernym
xe_đạp tháng False	Random
thứ_năm thứ_hai False	co-hypernym
ghế ghế_dài True	hypernym
đèn_cầy hạt_óc_chó False	Random
viêm_não bệnh_tâm_thần False	co-hypernym
cây cây_thông True	hypernym
hoa_râm_bụt hạt_hạnh_nhân False	Random
mưa_bụi mưa_rào False	co-hypernym
cá cá_chép True	hypernym
thú khỉ_mõm_chó False	Random
giường_thất_bảo giường_gấp False	co-hypernym
cây_ăn_quả nhãn True	hypernym
khỉ_mặt_chó bò_brahman False	Random
ba_chỉ thịt_heo False	co-hypernym
cây_ăn_quả cây_táo True	hypernym
sự_uỷ_thác bèo_cái False	Random
lê hồng False	co-hypernym
cây_ăn_quả cây_bưởi True	hypernym
hoa_bách_hợp bếp_củi False	Random
tủ_tài_liệu tủ_chạn False	co-hypernym
ốc ốc_vặn True	hypernym
ghế_dài cây_ăn_quả False	Random
cá_chuối cá_lóc False	co-hypernym
hạt đậu_phộng True	hypernym
hồng_nhung mùa_đông False	Random
cải_bông_trắng đậu_hà_lan False	co-hypernym
khỉ khỉ_đuôi_ngắn True	hypernym
chó_ngao gà_mái_ghẹ False	Random
nhạc_tài_tử nhạc_nhẹ False	co-hypernym
tranh tranh_sơn_mài True	hypernym
nhạc_pop bò_đực False	Random
cá_chép cá_trôi False	co-hypernym
kính kính_cận True	hypernym
danh_tiếng chim_biển False	Random
măng_cụt lê False	co-hypernym
cá cá_chim True	hypernym
đàn_tranh chả False	Random
củ_năng dưa_chuột False	co-hypernym
bệnh bệnh_sởi True	hypernym
đau_bụng su_su False	Random
tỏi diếp_cá False	co-hypernym
gia_vị nước_mắm True	hypernym
ốc_mít cá_voi False	Random
khoai_lang khoai_mì False	co-hypernym
chất_lỏng dầu True	hypernym
khoai_mì cây_mít False	Random
dâu_tây táo False	co-hypernym
nấm nấm_hương True	hypernym
táo_đường cây_thông False	Random
cây_cỏ cây_cổ_thụ False	co-hypernym
máy máy_bơm True	hypernym
ghế_xoay mũ False	Random
đèn_cao_áp đèn_pin False	co-hypernym
quần quần_lót True	hypernym
chim_khách thương_hàn False	Random
lá_nốt khổ_qua False	co-hypernym
quạt quạt_mo True	hypernym
hồng_bạch gà_pha False	Random
tranh_thuỷ_mạc tranh_lụa False	co-hypernym
củ cà_rốt True	hypernym
nước_suối thịt_bê False	Random
tủ_tài_liệu tủ_hồ_sơ False	co-hypernym
củ khoai_tây True	hypernym
mơ mưa_xuân False	Random
dưa_hấu xoài False	co-hypernym
củ khoai_lang True	hypernym
lê thịt False	Random
cây_bóng_mát cây_xanh False	co-hypernym
hoa hoa_hướng_dương True	hypernym
thuốc_bôi quạt_mo False	Random
cây_nhãn cây_cổ_thụ False	co-hypernym
tôm tôm_sú True	hypernym
lúa_mì mít False	Random
cá_mè cá_mú False	co-hypernym
hoa hoa_lau True	hypernym
lê tranh_tường False	Random
viêm_phế_quản bệnh_lây_lan False	co-hypernym
dấu dấu_chấm_phẩy True	hypernym
nhạc_nhẹ mũ_phớt False	Random
khỉ_độc khỉ_mũi_hẹp False	co-hypernym
hoa hoa_ban True	hypernym
quần máy_tính_xách_tay False	Random
cá_đuối cá_chim False	co-hypernym
Rau_thơm hành_tây True	hypernym
chả_tôm cá_bống_tượng False	Random
cá_rô_phi cá_nục False	co-hypernym
âm_nhạc nhạc_thính_phòng True	hypernym
trả_giá cây_phi_lao False	Random
khổ_qua giá False	co-hypernym
cá cá_cơm True	hypernym
bạc_hà mùa False	Random
cá_vàng cá_thu False	co-hypernym
bánh bánh_bông_lan True	hypernym
bánh_mỳ bích_qui False	Random
hồng_xiêm xoài False	co-hypernym
rau_củ củ_sen True	hypernym
cam gạch_ngói False	Random
khỉ_mặt_chó khỉ_mũi_hẹp False	co-hypernym
bèo bèo_hoa_dâu True	hypernym
bò_tót gà_mái False	Random
mít dâu_tây False	co-hypernym
âm_nhạc nhạc_dân_gian True	hypernym
chim_chích chôm_chôm False	Random
thuốc_hoàn_tán thuốc_bôi False	co-hypernym
cửa cửa_sổ True	hypernym
cây_leo hành_lá False	Random
dấu_phẩy dấu_hỏi False	co-hypernym
hạt hạt_óc_chó True	hypernym
cây_cau mũ_đồng_phục False	Random
dầu_ăn nước_mắm False	co-hypernym
màu_sắc da_cam True	hypernym
cá_da_trơn lược_thưa False	Random
ổi lê False	co-hypernym
màu_sắc xanh_da_trời True	hypernym
dâu_tây bánh False	Random
bệnh_kí_sinh_trùng bệnh_bẩm_sinh False	co-hypernym
báo báo_hình True	hypernym
chổi_đót vịt_lưỡi_liềm False	Random
dưa_hồng vú_sữa False	co-hypernym
âm nguyên_âm True	hypernym
cây_xương_rồng sắn False	Random
giường_nằm giường_gấp False	co-hypernym
Cá cá_heo True	hypernym
chả_cốm cá_rô_phi False	Random
chim_yến chim_bồ_câu False	co-hypernym
thương thương_yêu True	hypernym
bánh_cuốn đường_tinh_luyện False	Random
hoa_đào hoa_cẩm_chướng False	co-hypernym
ghế ghế_mây True	hypernym
giường_xếp thuốc_uống False	Random
cây_cà_phê cây_cỏ False	co-hypernym
chả chả_cốm True	hypernym
cá_bơn âm_mưu False	Random
cây_cà_phê cây_bóng_mát False	co-hypernym
rau húng_quế True	hypernym
gà_sống chó_ngao False	Random
xà_lách giá False	co-hypernym
tháng tháng_chạp True	hypernym
sinh_học rắn_mối False	Random
lục vàng False	co-hypernym
gà gà_tre True	hypernym
bệnh_kí_sinh_trùng bệnh_truyền_nhiễm_qua_không_khí False	Random
dấu_hai_chấm dấu_sắc False	co-hypernym
âm tiếng_ồn_ào True	hypernym
sữa cung_cấp False	Random
su_hào su_su False	co-hypernym
ốc ốc_nhồi True	hypernym
bếp_từ dấu_hỏi False	Random
gà_mái_tơ gà_đông_cảo False	co-hypernym
khỉ khỉ_độc True	hypernym
tranh_minh_hoạ viêm_não False	Random
cây_mít cây_cảnh False	co-hypernym
cây cây_bóng_mát True	hypernym
rắn_mối khỉ_mũi_hẹp False	Random
viêm_phế_quản bệnh_sốt_rét False	co-hypernym
cây_lương_thực khoai_tây True	hypernym
tiếng_nhạc tôm_he False	Random
bệnh_nặng bệnh_bội_nhiễm False	co-hypernym
bệnh bệnh_truyền_nhiễm_qua_không_khí True	hypernym
tủ_chè tháng False	Random
hoa_sen hoa_ly False	co-hypernym
bếp bếp_điện True	hypernym
đau_dạ_dày chà_là False	Random
cây_sung cây_đào False	co-hypernym
bếp bếp_từ True	hypernym
dép_quai_hậu yêu_đơn_phương False	Random
hoa_lau hoa_phong_lan False	co-hypernym
báo báo_thanh_niên True	hypernym
tranh_thuỷ_mạc thứ_ba False	Random
bơ đu_đủ False	co-hypernym
rau xu_hào True	hypernym
chả vịt_mồng False	Random
long_già lòng_non False	co-hypernym
chất_lỏng rượu True	hypernym
văn_học bánh_đa False	Random
mũ_nan mũ_bảo_hiểm False	co-hypernym
chất_lỏng bia True	hypernym
thịt_gà tiền_xu False	Random
cá_voi cá_rô False	co-hypernym
chim chim_ưng True	hypernym
cây_hoa bột_cà_ri False	Random
bí_đao hẹ False	co-hypernym
thuốc thuốc_tây True	hypernym
rắn_ráo nước False	Random
cây_điều cây_công_nghiệp False	co-hypernym
thuốc nhân_sâm True	hypernym
bò_dái đường False	Random
nước_lợ nước_ngọt False	co-hypernym
thịt bắp_bò True	hypernym
kiết_lị máy False	Random
trung_cấp trường_cao_đẳng False	co-hypernym
thịt nạc_vai True	hypernym
tình_dục mãng_cầu False	Random
bếp_từ bếp_than False	co-hypernym
đường đường_tinh_luyện True	hypernym
nhạc_trữ_tình tía_tô False	Random
cá_linh cá_tầm False	co-hypernym
bệnh bệnh_sốt_rét True	hypernym
mơ trả_nợ False	Random
bò_nuôi bò_brahman False	co-hypernym
gạch gạch_nung True	hypernym
tủ_hồ_sơ khỉ_mặt_chó_tây_phi False	Random
dưa_chuột hẹ False	co-hypernym
cây cây_ổi True	hypernym
dấu_chấm_phẩy chim_chích_chòe False	Random
cá_da_trơn cá_vàng False	co-hypernym
bát bát_tô True	hypernym
danh nhạc_rock False	Random
chàm xanh False	co-hypernym
gà gà_chọi True	hypernym
dâu_tây thuốc_bôi False	Random
cá_nục cá_vàng False	co-hypernym
gà gà_đông_tảo True	hypernym
nấm_trắng cá_chim False	Random
tủ_tài_liệu tủ_lạnh False	co-hypernym
thuốc thuốc_bắc True	hypernym
dưa_hồng phim_điện_ảnh False	Random
tranh_lụa tranh_khắc_đồng False	co-hypernym
sữa sữa_ong_chúa True	hypernym
hoa_địa_lan tôm_hùm False	Random
giá rau_diếp False	co-hypernym
dấu dấu_ngã True	hypernym
trĩ áo_sơ_mi False	Random
ghế_gấp ghế_xôpha False	co-hypernym
hạt hạt_mít True	hypernym
bí_đao thuốc_hoàn_tán False	Random
su_hào cà_tím False	co-hypernym
môn_học hóa True	hypernym
thịt_chó chim_chích False	Random
da_cam đỏ False	co-hypernym
rau_củ su_hào True	hypernym
tháng_chạp tím False	Random
hoa_phượng hoa_phong_lan False	co-hypernym
bò bò_hoang_châu_á True	hypernym
thịt_heo tình_yêu False	Random
dâu_tây mận False	co-hypernym
Mưa mưa_rào True	hypernym
đàn bát False	Random
mồng_tơi măng False	co-hypernym
rắn rắn_cạp_nia True	hypernym
cá_mú phim False	Random
sung chà_là False	co-hypernym
vịt vịt_cỏ True	hypernym
lược_thưa gạch_hoa False	Random
đậu_bắp cải_bông_xanh False	co-hypernym
hoa hoa_giành_giành True	hypernym
dứa bánh_cuốn False	Random
vú_sữa dâu_tây False	co-hypernym
hạt hạt_sen True	hypernym
cây_bưởi cỏ_dại False	Random
máy_rửa_bát máy_cầy False	co-hypernym
ghế ghế_matxa True	hypernym
tháng cải_bắp_tím False	Random
nấm_linh_chi nấm_kim_châm False	co-hypernym
thịt thịt_rừng True	hypernym
khoai_tây bánh_bông_lan False	Random
cây_nông_nghiệp cây_mít False	co-hypernym
cửa cửa_cuốn True	hypernym
viêm_não hoa_râm_bụt False	Random
tủ_đông_lạnh tủ_quần_áo False	co-hypernym
bò bê True	hypernym
cây_cối xe_đạp False	Random
ớt_đà_lạt khoai_môn False	co-hypernym
xe xe_đạp True	hypernym
ngoan_ngoãn tiền_vàng False	Random
dâu_gia lê False	co-hypernym
bệnh ho_gà True	hypernym
bia cho_phép False	Random
hoa_bằng_lăng hoa_phượng False	co-hypernym
cây_ăn_quả đào True	hypernym
hạt_dẻ bệnh_tâm_thần False	Random
phong_lan hoa_cúc False	co-hypernym
ghế ghế_nệm True	hypernym
âm_thanh hoa_bằng_lăng False	Random
quạt_giấy quạt_nan False	co-hypernym
gà gà_lôi True	hypernym
cây_dừa thuốc_bắc False	Random
bột_ngọt đường False	co-hypernym
cây cây_mía True	hypernym
ôtô bơ False	Random
cá_bơn cá_bống False	co-hypernym
bánh bánh_bò True	hypernym
hồi_trống vẹt False	Random
cá_quả cá_lóc False	co-hypernym
cây_lương_thực khoai_môn True	hypernym
cam_sành đậu_hà_lan False	Random
dầu_ô_liu dầu_ăn False	co-hypernym
gà gà_tam_hoàng True	hypernym
dưa_chuột ong_bò_vẽ False	Random
cao_đẳng đại_học False	co-hypernym
cỏ cỏ_ba_lá True	hypernym
khỉ chổi_xể False	Random
tủ_đá tủ_chữa_cháy False	co-hypernym
âm_nhạc nhạc_vàng True	hypernym
tháng_giêng bò_u_ấn_độ False	Random
nấm_tử_thần nấm_trắng False	co-hypernym
bệnh bệnh_phổi True	hypernym
lam cá_trắm False	Random
hoa_đồng_tiền hoa_sen False	co-hypernym
gia_vị nước_tương True	hypernym
cây_bụi quạt_treo_tường False	Random
cây_bóng_mát cây_cảnh False	co-hypernym
sữa sữa_tươi True	hypernym
phim_nhựa hạt_diều False	Random
cây_phi_lao cây_cảnh False	co-hypernym
cây_lương_thực lúa_mì True	hypernym
mưu_đồ khỉ_đột False	Random
cải_bông_xanh thì_là False	co-hypernym
gà gà_sống True	hypernym
hoa_lan tình_tứ False	Random
chim_chào_mào chim_sẻ False	co-hypernym
mưu mưu_toan True	hypernym
khỉ đu_đủ False	Random
cây_công_nghiệp cây_cối False	co-hypernym
gia_vị mù_tạt True	hypernym
rắn_giun ốc_bươu_vàng False	Random
cây_cà_phê cây_lương_thực False	co-hypernym
thú trâu True	hypernym
hoa_lau rắn_chuông False	Random
uốn_ván bệnh_sốt_rét False	co-hypernym
mùa mùa_hè True	hypernym
chim_sẻ sự_uỷ_nhiệm False	Random
ốm_vặt bệnh_truyền_nhiễm False	co-hypernym
ghế ghế_xoay True	hypernym
bệnh_phụ_nữ chả_mực False	Random
sự_uỷ_thác chứng_nhận False	co-hypernym
môn_học lý True	hypernym
cung cây_chè False	Random
bếp_lửa bếp_trấu False	co-hypernym
gà gà_giò True	hypernym
cá_bống dấu_hỏi False	Random
cá_ngừ_đại_dương cá_linh False	co-hypernym
giường giường_cho_bé True	hypernym
bánh_cuốn cây_gỗ False	Random
thịt_rừng bắp_bò False	co-hypernym
cá_trắm cá_trắm_cỏ True	hypernym
phim_trinh_thám sa_kê False	Random
rắn_ráo rắn_giun False	co-hypernym
bệnh viêm_phổi True	hypernym
lúa_mì âm_vị False	Random
nấm_linh_chi nấm_mối False	co-hypernym
tiền tiền_giấy True	hypernym
dứa hoa_anh_đào False	Random
cây_phi_lao cây_xanh False	co-hypernym
yêu yêu_đơn_phương True	hypernym
rau_chân_vịt hoa_bằng_lăng False	Random
khỉ_đột khỉ_mặt_chó False	co-hypernym
tóc tóc_đen True	hypernym
hoa_oải_hương rắn_giun False	Random
đậu_hà_lan nấm False	co-hypernym
chim gõ_kiến True	hypernym
khỉ_mõm_chó cà_chua False	Random
viêm_xoang tạp_bệnh False	co-hypernym
ghế ghế_sofa True	hypernym
tháng_hai quần_đùi False	Random
viêm_não bệnh_thận False	co-hypernym
cá_trắm cá_trắm_đen True	hypernym
uốn_ván ổi False	Random
dấu_sắc dấu_hỏi False	co-hypernym
rau_củ cải_bắp_tím True	hypernym
da_cam đèn False	Random
cây_nhãn cây_lương_thực False	co-hypernym
củ củ_đậu True	hypernym
bí_đao ghế_mây False	Random
trường_cao_đẳng trường_tiểu_học False	co-hypernym
thuốc thuốc_uống True	hypernym
cá_cơm bệnh False	Random
cây_dừa cây_trồng False	co-hypernym
mũ mũ_vành True	hypernym
dấu_phẩy máy_bơm False	Random
gà_rừng gà_giò False	co-hypernym
chim chim_chào_mào True	hypernym
bếp_nướng bơ False	Random
dâu_tây lê False	co-hypernym
Rau_thơm húng_chó True	hypernym
tình_tứ phong_lan False	Random
ghế_sofa ghế_dài False	co-hypernym
gà gà_tơ True	hypernym
bếp_từ giường False	Random
chột_đồng chuột_nhắt False	co-hypernym
giường giường_nằm True	hypernym
giá Cá False	Random
bánh_bò bánh_bèo False	co-hypernym
gia_vị chanh True	hypernym
cá_thu bò_nhà False	Random
cá_lăng cá_nục False	co-hypernym
màu_sắc đỏ True	hypernym
viêm_phế_quản cây_xanh False	Random
cá_hồng cá_heo False	co-hypernym
chuối chuối_mật True	hypernym
phong_lan lý False	Random
viêm_xoang bệnh_thường_gặp False	co-hypernym
kính kính_áp_tròng True	hypernym
bệnh_tâm_thần rắn_độc False	Random
tóc_vàng tóc_đỏ False	co-hypernym
phim phim_hoạt_hình True	hypernym
gà_trống thuốc_tây False	Random
gà_tam_hoàng gà_hoa_mơ False	co-hypernym
tình tình_yêu True	hypernym
lan_vũ_nữ gà_tây False	Random
viêm_xoang viêm_khí_quản False	co-hypernym
ong ong_bò_vẽ True	hypernym
bánh_đa bàn_học False	Random
cần_nước giá False	co-hypernym
tranh tranh_biếm_hoạ True	hypernym
bát ghế_điện False	Random
cây_thông cây_ăn_trái False	co-hypernym
hoa hoa_thược_dược True	hypernym
ốc_nướng ghế_dài False	Random
ổi táo False	co-hypernym
hạt hạt_dưa True	hypernym
ốc_bươu_vàng củ_sắn False	Random
tranh_thuỷ_mạc tranh_khoả_thân False	co-hypernym
bóng bóng_bàn True	hypernym
khỉ_đuôi_ngắn đèn_cao_áp False	Random
cây_phi_lao cây_lúa False	co-hypernym
bệnh bệnh_bội_nhiễm True	hypernym
rau_thơm tranh_minh_hoạ False	Random
tiếng âm_vị False	co-hypernym
Mưa mưa_bay True	hypernym
ốc_vặn cá_ngừ_đại_dương False	Random
đường_kính đường_tinh_luyện False	co-hypernym
rau rau_ngót True	hypernym
tranh_khắc_đồng lược False	Random
gà_sống gà_ri False	co-hypernym
cung cung_cấp True	hypernym
ốc_xào dép_quai_hậu False	Random
củ_sen rau_diếp False	co-hypernym
giường giường_của_bé True	hypernym
cây_hoa cá_quả False	Random
hoa_mười_giờ hoa_lau False	co-hypernym
tranh tranh_phong_cảnh True	hypernym
học dấu_phẩy False	Random
cá_đuối cá_lóc False	co-hypernym
bàn bàn_làm_việc True	hypernym
cây_cọ thuốc_hoàn_tán False	Random
viêm_phế_quản bệnh_tim False	co-hypernym
bếp bếp_củi True	hypernym
đèn_ngủ đau_lưng False	Random
hoa_giành_giành hoa_cúc False	co-hypernym
cá cá_mập True	hypernym
trĩ sự_giao_phó False	Random
chim_biển chim_bồ_câu False	co-hypernym
đèn đèn_chiếu_sáng True	hypernym
vịt_mỏ_nhọn kiến_lửa False	Random
cải_bông_trắng rau_diếp False	co-hypernym
âm_nhạc nhạc_cổ_điển True	hypernym
ho_gà bàn_làm_việc False	Random
khế chà_là False	co-hypernym
hoa hoa_oải_hương True	hypernym
xe_đạp gia_vị False	Random
dâu_gia chà_là False	co-hypernym
rau cà_chua True	hypernym
chó_kiến đàn_guitar False	Random
nhạc_tài_tử nhạc_dân_gian False	co-hypernym
hoa hoa_bách_hợp True	hypernym
cá_chuối phong_lan False	Random
tiếng_ồn_ào tiếng_nhạc False	co-hypernym
hoa hoa_súng True	hypernym
bệnh_truyền_nhiễm_qua_không_khí voi False	Random
cá_voi cá_heo False	co-hypernym
cam cam_vinh True	hypernym
nước_biển hoa_súng False	Random
mưu_mô mưu_đồ False	co-hypernym
báo báo_nhân_dân True	hypernym
hạt_hướng_dương giường_tàu False	Random
tranh_màu_nước tranh_lụa False	co-hypernym
bệnh tạp_bệnh True	hypernym
măng_tây lúa_nước False	Random
mướp ớt_đà_lạt False	co-hypernym
bút bút_chì True	hypernym
cá_nục máy_tính_xách_tay False	Random
mưu_mô mưu_hại False	co-hypernym
cung cung_ứng True	hypernym
chim_ưng bệnh_phổi False	Random
cá_trắm_đen cá_ba_sa False	co-hypernym
Cá cá_trê True	hypernym
vịt_mào ong_bò_vẽ False	Random
tranh_tết tranh_khắc_đồng False	co-hypernym
thú cá_sấu True	hypernym
vịt_bơ thịt_bê False	Random
sắn khoai_môn False	co-hypernym
mũ mũ_nan True	hypernym
bệnh_sốt_rét máy_tính False	Random
tâm_lý_học văn_học False	co-hypernym
âm_nhạc pop True	hypernym
máy_tính_điện_tử bằng_lăng False	Random
chim_yến chim_kền_kền False	co-hypernym
quạt quạt_trần True	hypernym
đèn_giao_thông ghế_dựa False	Random
cây_cổ_thụ cây_xoan False	co-hypernym
chim chim_chích_chòe True	hypernym
bệnh_kí_sinh_trùng khỉ_mũi_hẹp False	Random
su_hào rau_chân_vịt False	co-hypernym
chả chả_tôm True	hypernym
cây_xương_rồng cải_bông_trắng False	Random
thanh_long chà_là False	co-hypernym
tháng tháng_một True	hypernym
hoa_phong_lan dưa_gang False	Random
hoa_loa_kèn hoa_huệ False	co-hypernym
chả chả_rế True	hypernym
cá_hồi chả_cốm False	Random
khỉ_đuôi_ngắn khỉ_mõm_chó False	co-hypernym
đèn đèn_flash True	hypernym
bếp_lò hoa_hồng False	Random
cải_bông_xanh xà_lách False	co-hypernym
nấm nấm_mối True	hypernym
thịt_rừng cây_cổ_thụ False	Random
lá_nốt su_hào False	co-hypernym
hạt hạt_diều True	hypernym
máy_gặt báo_hình False	Random
lúa_mì khoai_mì False	co-hypernym
cỏ cỏ_gà True	hypernym
ốc_luộc lị_nhiễm_khuẩn False	Random
kiến_cánh kiến_vàng False	co-hypernym
trả trả_thù True	hypernym
máy_rửa_bát chột_đồng False	Random
cây_ổi cây_keo False	co-hypernym
bệnh lị_nhiễm_khuẩn True	hypernym
mũ_nồi chim_cu_gáy False	Random
hoa_thược_dược hoa_cẩm_tú_cầu False	co-hypernym
cá cá_mú True	hypernym
cà_rốt vịt_bơ False	Random
cá_chình cá_trê False	co-hypernym
Mưa mưa_bóng_mây True	hypernym
phim_tài_liệu tủ_đông_lạnh False	Random
bệnh_sởi bệnh_nặng False	co-hypernym
gà gà_mái_ghẹ True	hypernym
tình_dục táo False	Random
cần_nước xà_lách False	co-hypernym
bò bò_tót True	hypernym
kiến_lửa lam False	Random
bệnh_sốt_rét bệnh_thận False	co-hypernym
rau bắp_cải True	hypernym
cá_mú cải_bắp_tím False	Random
cá_ngừ_đại_dương cá_trôi False	co-hypernym
súp_lơ súp_lơ_xanh True	hypernym
bò_zebu sữa_ong_chúa False	Random
tía_tô hành_tây False	co-hypernym
quần quần_đùi True	hypernym
tủ_kính_trưng_bày hoa_râm_bụt False	Random
củ_sen sả False	co-hypernym
giường giường_gấp True	hypernym
hạt cỏ False	Random
dâu_gia măng_cụt False	co-hypernym
cây_ăn_quả chôm_chôm True	hypernym
đèn_cao_áp nhạc_pop False	Random
cá_mú cá_trắm False	co-hypernym
cây_ăn_quả xoài True	hypernym
hoa_oải_hương báo_hình False	Random
thuốc_ngâm thuốc_bắc False	co-hypernym
danh danh_tiếng True	hypernym
muối cho_phép False	Random
cà_chua rau_thơm False	co-hypernym
thú bò True	hypernym
bếp_rơm thương_nhớ False	Random
su_su cà_tím False	co-hypernym
đồ_đạc tủ True	hypernym
chất_lỏng đèn False	Random
trường_đại_học trường_trung_học False	co-hypernym
rau_củ củ_năng True	hypernym
cú_mèo voi False	Random
bệnh_cảm_cúm bệnh_lây_lan False	co-hypernym
chim chim_yến True	hypernym
xoài_tượng ốc_luộc False	Random
đèn_ngủ đèn_điện False	co-hypernym
cây_ăn_quả đu_đủ True	hypernym
đường_cát dép_lê False	Random
cá_linh cá_cảnh False	co-hypernym
hoa hoa_bằng_lăng True	hypernym
cây_cau xà_lách False	Random
bệnh_truyền_nhiễm_qua_không_khí bệnh_tâm_thần False	co-hypernym
khỉ khỉ_mặt_chó_tây_phi True	hypernym
sa_kê chả_giò False	Random
cá_hồi cá_bống False	co-hypernym
thứ thứ_năm True	hypernym
dấu_chấm_phẩy bê False	Random
mồng_tơi bí_đao False	co-hypernym
thứ thứ_ba True	hypernym
gà_mái_ghẹ chả_quế False	Random
cá_nhám cá_bống False	co-hypernym
cây cây_phi_lao True	hypernym
cá_da_trơn mắm_tôm False	Random
nhạc_điện_tử nhạc_đỏ False	co-hypernym
cấp_phép ban_đặc_quyền True	hypernym
tranh_sơn_mài cây_cau False	Random
cửa_cuốn cửa_sổ False	co-hypernym
âm_nhạc nhạc_pop True	hypernym
cá_ba_sa máy_tính_cá_nhân False	Random
hoa_giành_giành hoa_dã_quỳ False	co-hypernym
khoa_học_xã_hội văn True	hypernym
tranh_tết cá_lăng False	Random
tủ_đông tủ_chè False	co-hypernym
chim chích_bông True	hypernym
đặc_cách hóa False	Random
nấm rau_thơm False	co-hypernym
hoa hoa_bưởi True	hypernym
trứng bát False	Random
tủ_đứng tủ_tài_liệu False	co-hypernym
đèn đèn_cầy True	hypernym
rau_dền gà_mái False	Random
cá_mập_trắng cá_lóc False	co-hypernym
ốc ốc_mít True	hypernym
chó_nuôi kiến False	Random
gà_tam_hoàng gà_lôi False	co-hypernym
phim phim_trinh_thám True	hypernym
chim_câu ho_gà False	Random
rắn_lục rắn_cạp_nia False	co-hypernym
cây cây_trồng True	hypernym
trường_trung_cấp bò_bizon False	Random
cá_quả cá_ba_sa False	co-hypernym
ốc ốc_luộc True	hypernym
tranh_minh_hoạ cung_ứng False	Random
cá_nheo cá_nhám False	co-hypernym
hoa hoa_mười_giờ True	hypernym
tranh_lụa tủ_đông_lạnh False	Random
bê bò_biển False	co-hypernym
âm_thanh hồi_trống True	hypernym
bát sữa_ong_chúa False	Random
tủ_sách tủ_hồ_sơ False	co-hypernym
tủ tủ_khoá True	hypernym
chim_cánh_cụt mầm_non False	Random
cá_ngừ cá_trôi False	co-hypernym
thứ thứ_tư True	hypernym
sự_giao_phó chó_pug False	Random
dưa_gang sa_kê False	co-hypernym
quạt quạt_nan True	hypernym
ghế_lười cá_cơm False	Random
hoa_tóc_tiên hoa_hướng_dương False	co-hypernym
kẹo kẹo_kéo True	hypernym
vẹt cỏ_gà False	Random
sầu_riêng nhãn False	co-hypernym
chó chó_sói True	hypernym
ghế_nhựa tủ_khoá False	Random
mưa_xuân mưa_phùn False	co-hypernym
kiến kiến_cánh True	hypernym
bò_brahman hoa_giành_giành False	Random
húng_quế rau_muống False	co-hypernym
rau_củ su_su True	hypernym
chuột_nhắt khỉ_độc False	Random
lựu bơ False	co-hypernym
bò bò_cái True	hypernym
dấu_phẩy khỉ_đầu_chó False	Random
sả măng_tây False	co-hypernym
bệnh bệnh_về_máu True	hypernym
tranh_sơn_mài công False	Random
ghế_nhựa ghế_xôpha False	co-hypernym
cây_ăn_quả sa_kê True	hypernym
xe_bò bánh_cáy False	Random
dầu rượu False	co-hypernym
hoa hoa_râm_bụt True	hypernym
bệnh_bẩm_sinh cỏ_gà False	Random
củ_năng cải_bông_trắng False	co-hypernym
kẹo kẹo_mút True	hypernym
máy_tính_để_bàn gà_pha False	Random
cây_xương_rồng cây_đào False	co-hypernym
thực_phẩm sữa True	hypernym
kiến sữa_bò False	Random
cây_sầu_riêng cây_dừa False	co-hypernym
tủ tủ_sách True	hypernym
cá_tra phim_hành_động False	Random
hạt_tiêu hành False	co-hypernym
màu_sắc xanh True	hypernym
đèn_lồng mũ_bảo_hộ False	Random
chim_yến vẹt False	co-hypernym
mưu mưu_đồ True	hypernym
đau_dạ_dày cỏ_ba_lá False	Random
cây_nông_nghiệp cây_hoa False	co-hypernym
rắn rắn_mai_gầm True	hypernym
gà_ác xanh False	Random
gà_thiến gà_đông_cảo False	co-hypernym
rau_củ bạc_hà True	hypernym
rắn_mối mưa_phùn False	Random
rau_diếp cà_tím False	co-hypernym
cây_ăn_quả dừa True	hypernym
tủ_kính_trưng_bày hip_hop False	Random
tủ_đông_lạnh tủ_bếp False	co-hypernym
âm tiếng_ồn True	hypernym
bệnh_phụ_nữ báo_nói False	Random
nấm_rơm nấm_mối False	co-hypernym
phong_lan lan_vũ_nữ True	hypernym
cần_nước tình_yêu False	Random
chàm đỏ False	co-hypernym
trả trả_giá True	hypernym
rau_thơm dưa_hấu False	Random
nhạc_sống nhạc_dân_tộc False	co-hypernym
âm tiếng True	hypernym
bàn măng_tây False	Random
sơ_ri chuối False	co-hypernym
mưu âm_mưu True	hypernym
nước_lợ đau_bụng False	Random
tranh_lụa tranh_khoả_thân False	co-hypernym
chuối chuối_tiêu True	hypernym
cà_tím cá_mập_trắng False	Random
măng_cụt đào False	co-hypernym
phim phim_truyền_hình True	hypernym
thú nấm_tử_thần False	Random
quạt_nan quạt_mo False	co-hypernym
bèo lục_bình True	hypernym
áo_phông dép_da False	Random
gà_tam_hoàng gà_ác False	co-hypernym
mũ mũ_lưỡi_trai True	hypernym
thực_phẩm máy_tính_xách_tay False	Random
nước_suối nước_lọc False	co-hypernym
tranh tranh_ảnh_minh_hoạ True	hypernym
bóng_bàn ốc False	Random
ốc_bươu_vàng ốc_luộc False	co-hypernym
cá cá_nục True	hypernym
áo_khoác chó_pit_bull False	Random
cây_cỏ cây_cối False	co-hypernym
chất_lỏng xăng True	hypernym
danh_dự hạt False	Random
tranh_lụa tranh_biếm_hoạ False	co-hypernym
cá cá_rô_phi True	hypernym
kiến công False	Random
cải_bắp_tím đậu_hà_lan False	co-hypernym
kiến kiến_xoan True	hypernym
tình_dục phim_truyền_hình False	Random
tương_ớt nước_mắm False	co-hypernym
rau_củ nấm True	hypernym
thuốc cây_thông False	Random
thì_là cần_tây False	co-hypernym
tôm tôm_hùm True	hypernym
tôm tủ False	Random
su_hào bầu False	co-hypernym
âm_nhạc nhạc_sống True	hypernym
chim_ưng hổ False	Random
cá_trắm_đen cá_nóc False	co-hypernym
trường_học trung_học True	hypernym
gà_ri ốm_vặt False	Random
củ_cải_trắng cải_bông_trắng False	co-hypernym
lược lược_thưa True	hypernym
đàn_guitar chổi False	Random
nhạc_dân_gian nhạc_nhẹ False	co-hypernym
môn_học văn True	hypernym
hóa_học cà_rốt False	Random
tranh_tường tranh_sơn_mài False	co-hypernym
tiền tiền_xu True	hypernym
củ_dền blues False	Random
mồng_tơi rau_chân_vịt False	co-hypernym
tủ tủ_chạn True	hypernym
bò_nhà đường_cát False	Random
tủ_li tủ_kính False	co-hypernym
tủ tủ_đông True	hypernym
dấu_sắc cá_quả False	Random
phim_điện_ảnh phim_hoạt_hình False	co-hypernym
đồ_đạc tranh True	hypernym
hóa chim_chích_chòe False	Random
cá_chình cá_lóc False	co-hypernym
rau_củ củ_hành_tây True	hypernym
hip_hop thịt_vai False	Random
cá_mú cá_lóc False	co-hypernym
mùa mùa_xuân True	hypernym
giày khỉ_độc False	Random
cá_mú cá_hồi False	co-hypernym
môn_học toán True	hypernym
thứ_hai rau_củ False	Random
ghế_gấp ghế_xích_đu False	co-hypernym
cây_ăn_quả táo True	hypernym
cà_chua phim_tư_liệu False	Random
dâu_tây đào False	co-hypernym
bò bò_bizon True	hypernym
mít cây_phi_lao False	Random
hồng_xiêm nhãn False	co-hypernym
giường giường_thất_bảo True	hypernym
báo_lá_cải mì_chính False	Random
cá_mập_trắng cá_chiên False	co-hypernym
bò bò_brahman True	hypernym
chanh ghế_lười False	Random
cây_xương_rồng cây_xanh False	co-hypernym
tranh tranh_khoả_thân True	hypernym
hoa_hồng gạch_hoa False	Random
tỏi ngò_tây False	co-hypernym
cây_ăn_quả dưa_gang True	hypernym
hồng_quế cây_sầu_riêng False	Random
củ_năng su_su False	co-hypernym
cá cá_đuối True	hypernym
cá_chình cây_mít False	Random
trường_trung_cấp trường_mầm_non False	co-hypernym
tháng tháng_ba True	hypernym
cây_lúa cần_tây False	Random
cần_nước ngò_tây False	co-hypernym
rau_củ bầu True	hypernym
thú bóng_tenis False	Random
cá_tra cá_chim False	co-hypernym
phương_tiện_có_bánh ôtô True	hypernym
tủ_bảo_hiểm sữa_bột False	Random
dưa_gang nhãn False	co-hypernym
vịt vịt_lưỡi_liềm True	hypernym
mùa_đông tranh_tết False	Random
rắn_hổ_mang rắn_cạp_nia False	co-hypernym
cá cá_mập_trắng True	hypernym
hoa_phượng sữa_ong_chúa False	Random
rắn_lửa rắn_cấc False	co-hypernym
ghế ghế_tựa True	hypernym
bệnh_lây_lan kiết_lị False	Random
cá_lóc cá_tra False	co-hypernym
âm_nhạc blues True	hypernym
tủ_đá gõ_kiến False	Random
cá_heo cá_sấu False	co-hypernym
nước nước_ngọt True	hypernym
nấm_mối vú_sữa False	Random
nhãn hồng False	co-hypernym
hạt hạt_bí True	hypernym
hạt_hướng_dương cửa_cuốn False	Random
dưa_chuột rau_thơm False	co-hypernym
tàu tàu_điện_ngầm True	hypernym
mơ uỷ_thác False	Random
chim_yến bồ_câu False	co-hypernym
đồ_đạc ghế True	hypernym
chiến_tranh_lạnh ngò_tây False	Random
dầu_ăn mắm_tôm False	co-hypernym
rau rau_muống True	hypernym
cỏ cá_trôi False	Random
cây_leo cây_cảnh False	co-hypernym
âm tiếng_nhạc True	hypernym
bếp_rơm cá_ba_sa False	Random
phim_tư_liệu phim_nhựa False	co-hypernym
hạt hạt_hạnh_nhân True	hypernym
thừa_nhận hạt_óc_chó False	Random
kẹo_mút kẹo_dừa False	co-hypernym
rau_củ rau_diếp True	hypernym
táo mùa_xuân False	Random
tủ_đựng_quần_áo tủ_đông False	co-hypernym
bệnh đau_dạ_dày True	hypernym
mồng_tơi ghế_dựa False	Random
bánh_gai bích_qui False	co-hypernym
cây cây_leo True	hypernym
nấm_sò tủ_đựng_quần_áo False	Random
sữa cá False	co-hypernym
gia_vị ớt_bột True	hypernym
thịt_heo công_nhận False	Random
bò_đực bò_rừng_bizon False	co-hypernym
ghế ghế_băng True	hypernym
củ_dền dừa False	Random
củ_dền bí_đao False	co-hypernym
khoa_học_xã_hội lịch_sử True	hypernym
bò_cái tình_duyên False	Random
khế hồng False	co-hypernym
cây_ăn_quả chà_là True	hypernym
gương_cầu_lồi phim_tài_liệu False	Random
hoa_mai hoa_hải_đường False	co-hypernym
phương_tiện_có_bánh xe_ngựa True	hypernym
đèn_giao_thông rau_cải False	Random
tóc_sâu tóc_đen False	co-hypernym
khỉ khỉ_trán_trắng True	hypernym
tháng_sáu gà_chọi False	Random
dấu_hai_chấm dấu_hỏi False	co-hypernym
cây cây_táo True	hypernym
hoa_loa_kèn áo_phông False	Random
cần_nước tỏi False	co-hypernym
rau_củ măng True	hypernym
cửa_sổ tóc_vàng False	Random
mù_tạt nước_tương False	co-hypernym
lòng long_già True	hypernym
trường_cao_đẳng sắn False	Random
sa_tế ớt_bột False	co-hypernym
gia_vị hạt_tiêu True	hypernym
ghế_điện bóng False	Random
cá_chuối cá_bống False	co-hypernym
bóng bóng_tenis True	hypernym
lục hoa_anh_đào False	Random
cải_bông_xanh hẹ False	co-hypernym
mưu mưu_mô True	hypernym
chim_yến bệnh_thận False	Random
gà_công_nghiệp gà_giò False	co-hypernym
cây cây_gỗ True	hypernym
gõ_kiến gà_ri False	Random
tủ_kính tủ_bảo_quản False	co-hypernym
chả chả_cá True	hypernym
tiền_giấy dấu_hỏi False	Random
jazz rock False	co-hypernym
cây cây_cối True	hypernym
chim_biển măng_tây False	Random
ớt_đà_lạt đậu_đũa False	co-hypernym
tủ tủ_bếp True	hypernym
cá_vàng sinh_học False	Random
mùa_xuân mùa_đông False	co-hypernym
rau_củ cà_tím True	hypernym
nguyên_âm phim_truyền_hình False	Random
thịt_vai thịt_chó False	co-hypernym
gia_vị mắm_tôm True	hypernym
cam_sành kẹo_kéo False	Random
dâu_tây đu_đủ False	co-hypernym
chim chim_cánh_cụt True	hypernym
giường_thờ chứng_nhận False	Random
uốn_ván bệnh_tâm_thần False	co-hypernym
bệnh kiết_lị True	hypernym
cá_chình tranh False	Random
cá_linh cá_ngừ False	co-hypernym
bệnh bệnh_bẩm_sinh True	hypernym
nhãn chả_rán False	Random
xe_máy xe_đạp False	co-hypernym
cam cam_chua True	hypernym
tủ_li hồng_nhung False	Random
hạt_bí hạt_diều False	co-hypernym
bệnh bệnh_cảm_cúm True	hypernym
tiền dâu_tây False	Random
dưa_gang dưa_hấu False	co-hypernym
tủ tủ_âm True	hypernym
gà_gô tôm_thẻ_chân_trắng False	Random
cá_nóc cá_mập False	co-hypernym
âm_nhạc nhạc_đỏ True	hypernym
cá_trôi cà_rốt False	Random
cây_leo cây_điều False	co-hypernym
âm_nhạc nhạc_tài_tử True	hypernym
chả_rán bánh_bông_lan False	Random
cá_mè cá_vàng False	co-hypernym
rắn rắn_chuông True	hypernym
bàn_học mưa_bão False	Random
gà_gô gà_chọi False	co-hypernym
tóc tóc_đỏ True	hypernym
rắn_lửa ốm_vặt False	Random
đèn_ngủ đèn_huỳnh_quang False	co-hypernym
thuốc thuốc_nam True	hypernym
jazz cá_thu False	Random
tiếng_nhạc bán_phụ_âm False	co-hypernym
cây_lương_thực khoai_mì True	hypernym
tàu_hỏa tủ_chữa_cháy False	Random
củ_khoai củ_cải False	co-hypernym
bò bò_nuôi True	hypernym
hoa_quỳnh đau_đầu False	Random
hoa_lan hoa_huệ False	co-hypernym
cá cá_voi True	hypernym
cây_xanh chuột False	Random
hạt_óc_chó hạt_sen False	co-hypernym
rau_củ rau_thơm True	hypernym
tủ_tài_liệu bạch_hầu False	Random
rắn_nước rắn_giun False	co-hypernym
đau đau_đầu True	hypernym
bếp_nướng gà_rừng False	Random
cây_dừa cây_bưởi False	co-hypernym
đàn đàn_piano True	hypernym
vịt_biển phim_trinh_thám False	Random
đậu_hà_lan ngò_tây False	co-hypernym
nấm nấm_mèo True	hypernym
cam quạt False	Random
thương_hàn lị_nhiễm_khuẩn False	co-hypernym
gia_vị tương_ớt True	hypernym
hoa_mai ghế_nhựa False	Random
gà_sống gà_chọi False	co-hypernym
bệnh bệnh_mãn_tính True	hypernym
đèn_pha đau_lưng False	Random
bò_nuôi bò_bizon False	co-hypernym
tủ tủ_ly True	hypernym
cú_mèo công False	Random
bí_đỏ bạc_hà False	co-hypernym
ghế ghế_xích_đu True	hypernym
đàn_guitar khỉ_mõm_chó False	Random
hoa_mào_gà hoa_cúc False	co-hypernym
rau_củ cải_bông_xanh True	hypernym
da_trời tình_duyên False	Random
cá_ngừ_đại_dương cá_sấu False	co-hypernym
quạt quạt_giấy True	hypernym
cá_nục giường_cho_bé False	Random
hoa_giành_giành hoa_dơn False	co-hypernym
trường_học tiểu_học True	hypernym
rắn_giun mũ_đồng_phục False	Random
cây_chè cây_trồng False	co-hypernym
tủ tủ_chè True	hypernym
gà_pha ghế_nệm False	Random
uốn_ván bệnh_bội_nhiễm False	co-hypernym
tình_cảm tình_yêu True	hypernym
đèn_cao_áp chuột_chù False	Random
tủ_đông tủ_khoá False	co-hypernym
nấm nấm_linh_chi True	hypernym
nấm_kim_châm rau_diếp False	Random
tranh_thêu tranh_màu_nước False	co-hypernym
gia_vị giấm True	hypernym
tranh chim False	Random
thì_là sả False	co-hypernym
môn_học địa_lý True	hypernym
cá_trích tủ_kính False	Random
thì_là rau_diếp False	co-hypernym
cây cây_chuối True	hypernym
bánh bơ False	Random
thịt_vai thịt_gà False	co-hypernym
thú hổ True	hypernym
phê_chuẩn dầu False	Random
ớt_đà_lạt diếp_cá False	co-hypernym
môn_học lịch_sử True	hypernym
bóng_bàn Rau_thơm False	Random
hành măng_tây False	co-hypernym
củ củ_cải True	hypernym
rau_củ ngoan_hiền False	Random
củ_hành_tây hành False	co-hypernym
cấp_phép sự_uỷ_quyền True	hypernym
nấm_độc cây_ăn_trái False	Random
mướp củ_năng False	co-hypernym
thực_phẩm gia_vị True	hypernym
xoài dưa_gang False	Random
gia_vị bánh False	co-hypernym
phim phim_hành_động True	hypernym
lục tóc_đen False	Random
tranh_màu_nước tranh_khắc_gỗ False	co-hypernym
rau_củ khổ_qua True	hypernym
hoa_lau chổi_xể False	Random
cá_cơm cá_trắm_đen False	co-hypernym
rắn rắn_biển True	hypernym
dấu_ngã mưa_xuân False	Random
hoa_đồng_tiền hoa_hồng False	co-hypernym
cấp_phép phê_chuẩn True	hypernym
hoa_địa_lan giường_bệnh False	Random
cây_bụi cây_cối False	co-hypernym
bệnh bạch_hầu True	hypernym
cây_xương_rồng tôm_he False	Random
hoa_râm_bụt hoa_cúc False	co-hypernym
gương gương_cầu_lồi True	hypernym
chuột_chù bát False	Random
hoa_mai hoa_cau False	co-hypernym
Mưa mưa_xuân True	hypernym
nước_mặn cần_tây False	Random
củ_hành_tây xà_lách False	co-hypernym
rau_củ bí_đỏ True	hypernym
gương_cầu_lồi xu_hào False	Random
cây_leo cây_táo False	co-hypernym
trường_học trường_mầm_non True	hypernym
gương_cầu_lõm đỏ False	Random
sơ_ri dứa False	co-hypernym
ốc ốc_bươu_vàng True	hypernym
sữa_bột ốc_nhồi False	Random
đèn_chùm đèn_chiếu_sáng False	co-hypernym
chả chả_quế True	hypernym
tranh_khắc_đồng bệnh_phụ_nữ False	Random
chim_kền_kền chào_mào False	co-hypernym
đèn đèn_ngủ True	hypernym
ngoan_ngoãn bát False	Random
hồng_xiêm sầu_riêng False	co-hypernym
cung cung_phụng True	hypernym
cá_mè chó_pug False	Random
dấu_sắc dấu_ngã False	co-hypernym
cây_ăn_quả sung True	hypernym
mưu lục False	Random
chà_là dâu_tây False	co-hypernym
táo táo_mèo True	hypernym
lược hoa_quỳnh False	Random
bánh_bò bánh_bao False	co-hypernym
rau_củ ớt_đà_lạt True	hypernym
trường_đại_học cây_nông_nghiệp False	Random
hoa_sen phong_lan False	co-hypernym
cây cây_cỏ True	hypernym
gương_cầu_lõm tôm False	Random
nấm_tử_thần nấm_mối False	co-hypernym
âm_nhạc nhạc_dân_tộc True	hypernym
sả dưa_chuột False	Random
cá_bống_tượng cá_ngừ False	co-hypernym
âm_nhạc jazz True	hypernym
rắn_hổ_lửa bò_tót False	Random
chim_chích vẹt False	co-hypernym
chổi chổi_xể True	hypernym
thuốc_tây văn False	Random
mũ_len mũ_phớt False	co-hypernym
gà gà_trống True	hypernym
viêm_xoang trĩ False	Random
bếp_củi bếp_gas False	co-hypernym
rau_củ khoai_môn True	hypernym
hoa_địa_lan hoa_cau False	Random
củ_hành_tây diếp_cá False	co-hypernym
chuột chột_đồng True	hypernym
bệnh_nặng công_nhận False	Random
hoa_giành_giành hoa_tóc_tiên False	co-hypernym
rau_củ cải_bông_trắng True	hypernym
pop quần_đùi False	Random
cây_thuốc cây_táo False	co-hypernym
tranh tranh_lụa True	hypernym
sữa_bò hoa_huệ False	Random
bánh_cuốn bánh_bao False	co-hypernym
tranh tranh_thuỷ_mặc True	hypernym
cam_sành măng_tây False	Random
cá_mè cá_nhám False	co-hypernym
rau_củ măng_tây True	hypernym
chim_chào_mào bàn False	Random
hoa_mười_giờ hoa_quỳnh False	co-hypernym
cam cam_cao_phong True	hypernym
quần ghế_cứng False	Random
cá_mú cá_trích False	co-hypernym
chanh chanh_leo True	hypernym
hoa_cẩm_tú_cầu long_già False	Random
cây_phượng cây_mít False	co-hypernym
dấu dấu_hai_chấm True	hypernym
gà_mái khỉ False	Random
thanh_long mận False	co-hypernym
dấu dấu_chấm True	hypernym
bí_đao gà_tơ False	Random
hoa_mười_giờ hoa_hướng_dương False	co-hypernym
tháng tháng_bảy True	hypernym
da_trời rượu False	Random
hoa_ban hoa_đồng_tiền False	co-hypernym
rau_củ xà_lách True	hypernym
chim_biển địa_lý False	Random
cây_lương_thực cây_cỏ False	co-hypernym
gà gà_mái_tơ True	hypernym
thuốc_uống rắn_lửa False	Random
ho_gà lị_nhiễm_khuẩn False	co-hypernym
động_vật gà True	hypernym
tôm_càng_xanh trường_trung_học False	Random
hoa_ban hoa_huệ False	co-hypernym
chim chim_hồng_hạc True	hypernym
cá_ngừ_đại_dương đau_bụng False	Random
cây_lan cây_táo False	co-hypernym
cây_lương_thực khoai_lang True	hypernym
đèn_chùm Mưa False	Random
hoa_bằng_lăng hoa_lau False	co-hypernym
chổi chổi_cọ True	hypernym
bí_đỏ cá_rô False	Random
hoa_cúc hoa_loa_kèn False	co-hypernym
thịt thịt_cầy True	hypernym
bóng_bàn tím False	Random
cá_voi cá_cảnh False	co-hypernym
hoa hoa_tóc_tiên True	hypernym
nhạc_sống cá_nước_ngọt False	Random
cần_nước đậu_hà_lan False	co-hypernym
trường_học trường_cao_đẳng True	hypernym
chuối_ngự cá_trắm_trắng False	Random
cá_quả cá_thu False	co-hypernym
chiến_tranh chiến_tranh_lạnh True	hypernym
dưa_chuột tháng_chạp False	Random
chim_ưng chim_cánh_cụt False	co-hypernym
hoa hoa_tuylip True	hypernym
lục xà_lách False	Random
cây_bụi cây_cà_phê False	co-hypernym
cấp_phép sự_uỷ_nhiệm True	hypernym
áo_sơ_mi dứa False	Random
khoai_môn rau_muống False	co-hypernym
cây_ăn_quả lê True	hypernym
phê_chuẩn màu_sắc False	Random
gà_đồng gà_đông_cảo False	co-hypernym
sữa sữa_bột True	hypernym
nhạc_điện_tử mũ_len False	Random
chim_khách công False	co-hypernym
màu_sắc nước_biển True	hypernym
bệnh_phụ_nữ ong_vàng False	Random
cần_nước hẹ False	co-hypernym
cây_ăn_quả mận True	hypernym
gạch_nung báo False	Random
cây_hoa cây_đào False	co-hypernym
gương gương_cầu_lõm True	hypernym
chim_khuyên bóng_bàn False	Random
tạp_bệnh bệnh_truyền_nhiễm False	co-hypernym
bếp bếp_hồng_ngoại True	hypernym
hoa_đồng_tiền đèn_lồng False	Random
hoa_lan hoa_phượng False	co-hypernym
nấm nấm_độc True	hypernym
hạt_dưa tình_bạn False	Random
thịt_vai bắp_bò False	co-hypernym
rau_củ thì_là True	hypernym
tranh_thuỷ_mặc ổi False	Random
cây_ăn_quả cây_trồng False	co-hypernym
học học_lại True	hypernym
chim_câu tủ_bảo_quản False	Random
cây_lạc cây_ổi False	co-hypernym
ngoan ngoan_ngoãn True	hypernym
máy_tính_cá_nhân sả False	Random
bánh_gai bánh_mì False	co-hypernym
tiền tiền_tệ True	hypernym
ong tủ_chạn False	Random
rắn_mai_gầm rắn_chuông False	co-hypernym
kiến kiến_ba_khoang True	hypernym
cà_chua củ_sen False	Random
măng bạc_hà False	co-hypernym
dép dép_da True	hypernym
thịt_rừng phim_hành_động False	Random
cá_trê cá_voi False	co-hypernym
cá cá_heo True	hypernym
lục môn_học False	Random
ghế_lười ghế_đôn False	co-hypernym
thú khỉ True	hypernym
mầm_non hoa_bằng_lăng False	Random
cây_bóng_mát cây_mít False	co-hypernym
cây_ăn_quả dâu_tây True	hypernym
cho_phép chào_mào False	Random
uốn_ván bệnh_truyền_nhiễm False	co-hypernym
áo áo_sơ_mi True	hypernym
kính_lão chả_cua False	Random
cây_bóng_mát cây_ăn_trái False	co-hypernym
cây cây_điều True	hypernym
cây_sầu_riêng bệnh_phổi False	Random
nấm hành False	co-hypernym
bánh bánh_gato True	hypernym
hổ sự_giao_phó False	Random
gà_công_nghiệp gà_chọi False	co-hypernym
tiền tiền_tài True	hypernym
ôtô ghế_vải False	Random
húng_chanh rau_đay False	co-hypernym
bếp bếp_gas True	hypernym
su_hào gà_đông_cảo False	Random
chim_chích chim_kền_kền False	co-hypernym
máy máy_tính True	hypernym
hoa_bằng_lăng cam_vinh False	Random
bếp_hồng_ngoại bếp_điện False	co-hypernym
cây_ăn_quả nho True	hypernym
tiếng_kêu lược False	Random
cá_nục cá_tra False	co-hypernym
giường giường_xếp True	hypernym
giường_xếp bệnh_sởi False	Random
nấm_kim_châm nấm_mối False	co-hypernym
tóc tóc_bạc True	hypernym
kính_lão tạp_bệnh False	Random
cà_chua tỏi_tây False	co-hypernym
giường giường_tàu True	hypernym
nước_mặn xoài_tượng False	Random
cây_leo cây_đào False	co-hypernym
tháng tháng_tám True	hypernym
phim_nhựa ghế_dù False	Random
cá_trích cá_heo False	co-hypernym
rau_củ đậu_bắp True	hypernym
cải_bắp_tím blues False	Random
cây_sầu_riêng cây_lương_thực False	co-hypernym
gia_vị ớt True	hypernym
cá_trắm củ_đậu False	Random
cây_keo cây_cối False	co-hypernym
phim phim_nhựa True	hypernym
rắn_chuông mưa_bóng_mây False	Random
rắn_ráo rắn_lục False	co-hypernym
cây cây_lâu_năm True	hypernym
bếp khoai_môn False	Random
hoa_súng hoa_cau False	co-hypernym
chuối chuối_hột True	hypernym
tủ_quần_áo bò_nuôi False	Random
cây_dừa cây_táo False	co-hypernym
bánh bánh_mì True	hypernym
lược cây_cỏ False	Random
măng măng_tây False	co-hypernym
cá cá_ngựa True	hypernym
đàn_piano sầu_riêng False	Random
ghế_điện ghế_gỗ False	co-hypernym
bệnh bệnh_tim True	hypernym
tóc_vàng tiểu_học False	Random
cá_rô_phi cá_ngừ False	co-hypernym
máy máy_gặt True	hypernym
khỉ_trán_trắng đèn_cao_áp False	Random
củ_sen hành False	co-hypernym
phương_tiện_có_bánh xe_máy True	hypernym
thuốc_tây bò_nái False	Random
ba_chỉ thịt_chó False	co-hypernym
cây cây_nhãn True	hypernym
máy_tính_điện_tử tranh_màu_nước False	Random
lê mận False	co-hypernym
ốc ốc_xào True	hypernym
hổ pop False	Random
chàm lục False	co-hypernym
đau đau_bụng True	hypernym
thừa_nhận quần False	Random
chà_là chuối False	co-hypernym
rau_củ rau_chân_vịt True	hypernym
tranh_màu_nước hoa_mào_gà False	Random
thanh_long vải False	co-hypernym
tủ tủ_bảo_hiểm True	hypernym
chó_thiến lúa_mì False	Random
cá_trắm_đen cá_nước_ngọt False	co-hypernym
gà gà_tây True	hypernym
xà_lách bóng False	Random
tranh_thuỷ_mặc tranh_màu_nước False	co-hypernym
tôm tôm_càng_xanh True	hypernym
ghế_dài đau_đầu False	Random
thịt_chó thịt_chim False	co-hypernym
chim vẹt True	hypernym
máy_cầy chim_kền_kền False	Random
bằng_lăng hoa_ly False	co-hypernym
đường đường_kính True	hypernym
đau_lưng su_hào False	Random
cá_linh cá_heo False	co-hypernym
động_vật thú True	hypernym
giày_thể_thao ốm_vặt False	Random
vịt_bơ vịt_mòng_két_mày_trắng False	co-hypernym
khoa_học_tự_nhiên toán True	hypernym
cá_ba_sa thứ_ba False	Random
ốc_bươu_vàng ốc_xào False	co-hypernym
hoa hoa_sen True	hypernym
nhạc_đỏ bắp_bò False	Random
cây_ổi cây_ăn_quả False	co-hypernym
cá cá_tầm True	hypernym
bạch_hầu cây_bụi False	Random
nước_biển xanh False	co-hypernym
học học_hỏi True	hypernym
rắn_giun xăng False	Random
cá_trắm_đen cá_thu False	co-hypernym
gà gà_đông_cảo True	hypernym
thịt_vai ghế_bành False	Random
ghế_dài ghế_cứng False	co-hypernym
tủ tủ_tường True	hypernym
mưa_phùn rắn_cạp_nong False	Random
giường_thờ giường_cho_bé False	co-hypernym
khoa_học_tự_nhiên hóa_học True	hypernym
tủ_li ghế_gỗ False	Random
hoa_đồng_tiền hoa_cúc False	co-hypernym
mùa mùa_đông True	hypernym
chó_pit_bull cây_lương_thực False	Random
dầu_ô_liu giấm False	co-hypernym
dấu dấu_phẩy True	hypernym
tranh_minh_hoạ ghế_tựa False	Random
đèn_vàng đèn_điện False	co-hypernym
hoa loa_kèn True	hypernym
chanh_đào tiếng_kêu False	Random
hoa_tóc_tiên hoa_phong_lan False	co-hypernym
danh danh_dự True	hypernym
bóng chim_khuyên False	Random
cá_chiên cá_nước_ngọt False	co-hypernym
cây_ăn_quả sơ_ri True	hypernym
thanh_long gừng False	Random
giường_thất_bảo giường_nằm False	co-hypernym
cây_ăn_quả mãng_cầu True	hypernym
giường_cho_bé đèn_pha False	Random
hóa_học hóa False	co-hypernym
chim chim_khuyên True	hypernym
su_hào dứa False	Random
viêm_khí_quản bệnh_sốt_rét False	co-hypernym
gia_vị đường True	hypernym
cây_đào hoa_mai False	Random
cá_trắm_đen cá_da_trơn False	co-hypernym
gia_vị bột_ngọt True	hypernym
nhạc_đỏ thực_phẩm False	Random
chim_cút công False	co-hypernym
gia_vị muối True	hypernym
tiếng_nhạc viêm_mũi False	Random
cá_lăng cá_trắm False	co-hypernym
cây_ăn_quả ổi True	hypernym
ghế_nhựa chanh_đào False	Random
tiếng_ồn tiếng_lồng False	co-hypernym
phương_tiện_có_bánh xe_đạp True	hypernym
cây_điều thứ False	Random
cà_chua xu_hào False	co-hypernym
nấm nấm_sò True	hypernym
chim_cút bếp_hồng_ngoại False	Random
vú_sữa mãng_cầu False	co-hypernym
mũ mũ_bảo_hiểm True	hypernym
chột_đồng lục False	Random
đèn_huỳnh_quang đèn_chùm False	co-hypernym
cấp_phép phê_duyệt True	hypernym
nhạc_thính_phòng cá_biển False	Random
cá_hồng cá_trắm False	co-hypernym
nước nước_lợ True	hypernym
cá_biển nấm_trắng False	Random
củ_hành_tây ngò_tây False	co-hypernym
cây_chuối cây_chuối_mỏ_phượng True	hypernym
xe_bò tháng_năm False	Random
khỉ_đầu_chó khỉ_mõm_chó False	co-hypernym
Mưa mưa_phùn True	hypernym
cá_đuối chim_khách False	Random
khế lê False	co-hypernym
táo táo_đường True	hypernym
dấu_sắc tủ_đứng False	Random
đèn_huỳnh_quang đèn_pha False	co-hypernym
phim phim_điện_ảnh True	hypernym
rau_dền dầu False	Random
hóa_học toán False	co-hypernym
âm_nhạc nhạc_jazz True	hypernym
cao_đẳng bệnh_da_ngoài_da False	Random
hoa_giành_giành hoa_tuylip False	co-hypernym
âm_nhạc hip_hop True	hypernym
ghế đường_phèn False	Random
húng_chanh xu_hào False	co-hypernym
khoa_học_tự_nhiên sinh_học True	hypernym
tủ_hồ_sơ rắn_hổ_lửa False	Random
tủ_hồ_sơ tủ_bảo_quản False	co-hypernym
thịt thịt_vai True	hypernym
thịt_lợn tình_duyên False	Random
cá_biển cá_trôi False	co-hypernym
bánh bích_qui True	hypernym
cây_phi_lao ốc_luộc False	Random
hoa_quỳnh hoa_bưởi False	co-hypernym
hoa hoa_anh_đào True	hypernym
hoa_đồng_tiền giường_xếp False	Random
giường_tàu giường_gấp False	co-hypernym
khỉ khỉ_mặt_chó True	hypernym
hẹ ốc_luộc False	Random
cây_leo cây_lan False	co-hypernym
quạt quạt_điện True	hypernym
hóa_học máy_tính_cá_nhân False	Random
thanh_long bơ False	co-hypernym
cá cá_nheo True	hypernym
pop tranh_màu_nước False	Random
gà_lôi gà_pha False	co-hypernym
thực_phẩm cá True	hypernym
khỉ_mõm_chó máy_tính_để_bàn False	Random
dưa_hấu dừa False	co-hypernym
tủ tủ_quần_áo True	hypernym
tranh_tết ngoan_ngoãn False	Random
cây_leo cây_cỏ False	co-hypernym
cá cá_nóc True	hypernym
xe_đạp tình_cảm False	Random
gà cá False	co-hypernym
cây cây_cọ True	hypernym
thuốc_bắc ong_vàng False	Random
cây_sung cây_cọ False	co-hypernym
tủ tủ_li True	hypernym
dừa mũ_vành False	Random
lị_nhiễm_khuẩn bệnh_gan False	co-hypernym
gia_vị dầu_ô_liu True	hypernym
bò_tót chim_chào_mào False	Random
viêm_phổi đau_dạ_dày False	co-hypernym
hạt hạt_dẻ True	hypernym
ghế_đôn chuột_chù False	Random
bệnh_nặng đau_dạ_dày False	co-hypernym
chim chim_chóc True	hypernym
kẹo_dừa củ_cải_trắng False	Random
rock pop False	co-hypernym
cá cá_tra True	hypernym
cam_đường phim_nhựa False	Random
bò_tơ bò_dái False	co-hypernym
thương thương_nhớ True	hypernym
sự_uỷ_nhiệm tương_ớt False	Random
cá_trích cá_biển False	co-hypernym
kính kính_loạn True	hypernym
lựu quần_dài False	Random
khế đào False	co-hypernym
âm tiếng_lồng True	hypernym
ốc_vặn tranh_sơn_mài False	Random
cây_chè cây_chuối False	co-hypernym
cam cam_sành True	hypernym
rau_ngót cá_nhám False	Random
tranh_thuỷ_mặc tranh_khoả_thân False	co-hypernym
bò bò_mộng True	hypernym
đu_đủ giường_thất_bảo False	Random
viêm_phế_quản bệnh_thận False	co-hypernym
bếp bếp_rơm True	hypernym
hoa_địa_lan rau_thơm False	Random
đậu_đũa ngò_tây False	co-hypernym
gia_vị mì_chính True	hypernym
bánh long_già False	Random
gà_ác gà_ri False	co-hypernym
bệnh bệnh_lây_lan True	hypernym
ngoan_hiền mưu_hại False	Random
khoai_môn ngò_tây False	co-hypernym
trường_học trường_đại_học True	hypernym
gà_gô gà_mái_ghẹ False	Random
trường_trung_cấp trung_học False	co-hypernym
máy_tính máy_tính_cá_nhân True	hypernym
cây_cỏ vịt_bơ False	Random
cá_chiên cá_tra False	co-hypernym
hoa hoa_phong_lan True	hypernym
hoa_loa_kèn trả_nợ False	Random
tranh_thuỷ_mạc tranh_dân_gian False	co-hypernym
cá cá_lóc True	hypernym
trả chó False	Random
cá_hồng cá_chiên False	co-hypernym
rau rau_đay True	hypernym
hoa_dã_quỳ đào False	Random
nhót đào False	co-hypernym
gà gà_công_nghiệp True	hypernym
hoa_đào cỏ False	Random
cây_ổi cây_bưởi False	co-hypernym
đồ_đạc giường True	hypernym
mưu_hại xích_lô False	Random
hoa_mai hoa_ly False	co-hypernym
rắn rắn_đuôi_chuông True	hypernym
hạt_mít khế False	Random
hoa_dã_quỳ hoa_cẩm_chướng False	co-hypernym
hoa hoa_huệ True	hypernym
sữa_bột lược False	Random
cá_trích cá_thu False	co-hypernym
cá cá_trắm_đen True	hypernym
chim_chích_chòe thì_là False	Random
thịt_vai thịt_thăn False	co-hypernym
hoa hoa_lan True	hypernym
cần_tây máy_rửa_bát False	Random
cá_mập_trắng cá_mập False	co-hypernym
rau khoai_tây True	hypernym
đậu_phộng tôm_he False	Random
tháng_giêng tháng_một False	co-hypernym
hoa hoa_đồng_tiền True	hypernym
tủ_hồ_sơ mùa_xuân False	Random
bát_sắt bát_sứ False	co-hypernym
thương thương_hại True	hypernym
thứ_ba hoa_loa_kèn False	Random
cá_trê cá_da_trơn False	co-hypernym
đèn đèn_neon True	hypernym
su_hào tranh_lụa False	Random
kiết_lị bệnh_lây_lan False	co-hypernym
cây_ăn_quả dứa True	hypernym
báo tháng_bảy False	Random
cây_cau cây_thuốc False	co-hypernym
bò bò_biển True	hypernym
mơ đu_đủ False	Random
rắn bò False	co-hypernym
rau_củ bí_đao True	hypernym
tủ_đông cam_sành False	Random
mì_chính muối False	co-hypernym
gà gà_hoa_mơ True	hypernym
bầu nhạc_cổ_điển False	Random
nhạc_điện_tử nhạc_đồng_quê False	co-hypernym
rắn rắn_nước True	hypernym
tủ_sách trường_mầm_non False	Random
cu_đơ bánh_bèo False	co-hypernym
cây cây_xoan True	hypernym
chó_sói tiếng_ồn False	Random
nhót chuối False	co-hypernym
âm bán_phụ_âm True	hypernym
bếp_gas tranh_thuỷ_mạc False	Random
bếp_lò bếp_củi False	co-hypernym
gia_vị sa_tế True	hypernym
tranh_lụa gà_đông_cảo False	Random
hoa_tuylip hoa_thược_dược False	co-hypernym
cá cá_trôi True	hypernym
mùa_thu trâu_nước False	Random
mãng_cầu đào False	co-hypernym
cây cây_keo True	hypernym
cây_nhãn chuột_cống False	Random
cây_táo cây_xoan False	co-hypernym
cây_ăn_quả chuối True	hypernym
rắn dấu_hỏi False	Random
dưa_gang dứa False	co-hypernym
mũ mũ_cối True	hypernym
ong_bò_vẽ gà_hoa_mơ False	Random
giường_xếp giường_gấp False	co-hypernym
máy máy_rửa_bát True	hypernym
bò_zebu báo_nhân_dân False	Random
su_hào giá False	co-hypernym
màu_sắc lục True	hypernym
giường_cho_bé cây_xương_rồng False	Random
viêm_xoang viêm_phổi False	co-hypernym
Rau_thơm tía_tô True	hypernym
chó_ngao tủ_quần_áo False	Random
cây_nông_nghiệp cây_lan False	co-hypernym
màu_sắc lam True	hypernym
chanh sữa_ong_chúa False	Random
cây_lương_thực cây_cối False	co-hypernym
sữa sữa_bò True	hypernym
hành_tây cam_đường False	Random
lá_nốt cải_bắp_tím False	co-hypernym
khỉ khỉ_vervet True	hypernym
bàn_học đèn_dầu False	Random
cá_trê cá_trắm False	co-hypernym
cây_ăn_quả nhót True	hypernym
dép_da tranh_phong_cảnh False	Random
cá_quả cá_tra False	co-hypernym
cá cá_biển True	hypernym
chích_bông cá_trắm_đen False	Random
da_cam chàm False	co-hypernym
rau_củ mồng_tơi True	hypernym
cây_gỗ gà_ri False	Random
cá_ngừ_đại_dương cá_thu False	co-hypernym
trường_học trung_cấp True	hypernym
bệnh_lây_lan thuốc_nam False	Random
đường_kính đường_cát False	co-hypernym
cây cây_lan True	hypernym
máy_cầy vật_lý False	Random
nhạc_jazz nhạc_nhẹ False	co-hypernym
gia_vị hành True	hypernym
bánh_cuốn tranh False	Random
hoa_mai hoa_địa_lan False	co-hypernym
bếp bếp_than True	hypernym
thương_hàn báo False	Random
lựu dâu_gia False	co-hypernym
chó chó_pit_bull True	hypernym
cá_nhám giường_bệnh False	Random
cá_bơn cá_da_trơn False	co-hypernym
âm_nhạc nhạc_phẩm True	hypernym
bát_sứ yêu_đương False	Random
củ_sắn củ_cải False	co-hypernym
bếp bếp_lò True	hypernym
khỉ_mặt_chó_tây_phi dấu False	Random
cà_chua rau_muống False	co-hypernym
hoa hoa_tầm_xuân True	hypernym
cá_nước_ngọt ốm_vặt False	Random
hoa_râm_bụt hoa_phượng False	co-hypernym
bánh bánh_cuốn True	hypernym
cam_chua tủ_hồ_sơ False	Random
viêm_phổi bạch_hầu False	co-hypernym
bệnh bệnh_gan True	hypernym
đèn_ngủ tàu False	Random
hoa_anh_đào bằng_lăng False	co-hypernym
bệnh bệnh_truyền_nhiễm True	hypernym
màu_sắc cú_mèo False	Random
cao_đẳng trường_cao_đẳng False	co-hypernym
bánh bánh_dẻo True	hypernym
ong bánh False	Random
cá_lăng cá_quả False	co-hypernym
đường đường_phèn True	hypernym
rắn_lửa mơ False	Random
củ_năng diếp_cá False	co-hypernym
bệnh uốn_ván True	hypernym
cây_hoa thuốc_uống False	Random
hoa_cẩm_tú_cầu hoa_phong_lan False	co-hypernym
máy_tính máy_tính_điện_tử True	hypernym
sự_cho_phép dép_quai_hậu False	Random
ba_chỉ thịt_bê False	co-hypernym
ghế ghế_mềm True	hypernym
gà_thiến gà_ác False	Random
cá_quả cá_trắm False	co-hypernym
bánh bánh_bèo True	hypernym
đào hạt_sen False	Random
cây_cối cây_táo False	co-hypernym
chim chim_câu True	hypernym
thương_hại cá_chép False	Random
tiếng_ồn bán_phụ_âm False	co-hypernym
hoa_hồng hồng_quế True	hypernym
tủ_quần_áo chuối_ngự False	Random
quạt_giấy quạt_điện False	co-hypernym
Rau_thơm cần_tây True	hypernym
củ_dền ghế_dài False	Random
rau_thơm măng_tây False	co-hypernym
rau_củ củ_dền True	hypernym
thuốc ghế_tựa False	Random
cá_bống_tượng cá_trắm False	co-hypernym
khỉ khỉ_mũi_hẹp True	hypernym
ngoan_hiền hóa False	Random
bò_zebu bò_tơ False	co-hypernym
ghế ghế_dựa True	hypernym
quạt_giấy bánh_mì False	Random
tỏi rau_diếp False	co-hypernym
khoa_học_xã_hội tâm_lý_học True	hypernym
chim_chích rắn_cạp_nong False	Random
cá_mập cá_lóc False	co-hypernym
chả chả_rán True	hypernym
sự_uỷ_nhiệm cá_trắm_trắng False	Random
hoa_huệ hoa_bách_hợp False	co-hypernym
chim chào_mào True	hypernym
hồi_trống hoa_tuylip False	Random
tỏi tỏi_tây False	co-hypernym
dép dép_lê True	hypernym
âm_mưu ghế_băng False	Random
phim_tư_liệu phim_tài_liệu False	co-hypernym
bệnh bệnh_nặng True	hypernym
thương_hại đậu_hà_lan False	Random
cá_mập_trắng cá_chép False	co-hypernym
hoa hoa_ly True	hypernym
viêm_não thuốc_bôi False	Random
tháng_chạp tháng_hai False	co-hypernym
táo táo_tàu True	hypernym
vật_lý ghế_sofa False	Random
cây_leo cây_lâu_năm False	co-hypernym
cá cá_trê True	hypernym
chôm_chôm chuột_cống False	Random
đèn_chùm đèn_báo_hiệu False	co-hypernym
cây_ăn_quả lựu True	hypernym
cỏ_ba_lá khỉ_mõm_chó False	Random
cá_lăng cá_sấu False	co-hypernym
nấm nấm_tử_thần True	hypernym
cá_chình cá_trôi False	Random
nhót vú_sữa False	co-hypernym
rau_củ giá True	hypernym
tủ_đứng cá_ngừ False	Random
hoa_mai hoa_loa_kèn False	co-hypernym
cá cá_trắm True	hypernym
tủ_ly tranh_khoả_thân False	Random
bò_sữa bò_hoang_châu_á False	co-hypernym
rau_củ tỏi True	hypernym
mùa_thu lược False	Random
cá_tầm cá_thu False	co-hypernym
cây cây_rau True	hypernym
cá_tra cây_cà_phê False	Random
bánh_cuốn bánh_bèo False	co-hypernym
trường_học đại_học True	hypernym
tủ_âm pop False	Random
cá_ba_sa cá_hồi False	co-hypernym
áo áo_khoác True	hypernym
dấu_phẩy phong_lan False	Random
viêm_xoang kiết_lị False	co-hypernym
Rau_thơm mùi_tàu True	hypernym
oải_hương bánh_bao False	Random
hồng_xiêm bơ False	co-hypernym
cá cá_bơn True	hypernym
dừa mưu_mô False	Random
cây_ổi cây_gỗ False	co-hypernym
khỉ khỉ_mõm_chó True	hypernym
mưu_toan măng_cụt False	Random
văn_học văn False	co-hypernym
thú sư_tử True	hypernym
đèn_chùm chổi_rơm False	Random
dưa_hấu chuối False	co-hypernym
dép dép_quai_hậu True	hypernym
nước_tương cá False	Random
hoa_sen hoa_địa_lan False	co-hypernym
tranh tranh_thêu True	hypernym
ớt_đà_lạt sữa_bột False	Random
cải_bông_xanh tỏi_tây False	co-hypernym
tủ tủ_đá True	hypernym
giường_gấp hoa_oải_hương False	Random
uốn_ván bệnh_tim False	co-hypernym
đèn đèn_dầu True	hypernym
giường mít False	Random
báo voi False	co-hypernym
bệnh thương_hàn True	hypernym
vịt_mỏ_nhọn cá_trê False	Random
đậu_đũa hành False	co-hypernym
thú voi True	hypernym
bút_bi bệnh_lây_lan False	Random
cây_leo cây_ăn_trái False	co-hypernym
ghế ghế_đôn True	hypernym
gà_tây hạt_bí False	Random
bệnh_sốt_rét bệnh_truyền_nhiễm False	co-hypernym
tình_cảm tình_bạn True	hypernym
toán ớt_bột False	Random
cá_trê cá_chim False	co-hypernym
hạt hạt_hướng_dương True	hypernym
hoa_dơn bò_cái False	Random
bò_đực bò_biển False	co-hypernym
chim chim_cút True	hypernym
chanh_leo nấm_hương False	Random
gà_trống gà_tây False	co-hypernym
mưa mưa_rào True	hypernym
áo chổi_rơm False	Random
nấm giá False	co-hypernym
lòng lòng_dạ True	hypernym
hoa_dơn mưa_xuân False	Random
cá_ngừ_đại_dương cá_biển False	co-hypernym
gia_vị bột_cà_ri True	hypernym
cam_cao_phong gà_đồng False	Random
máy_cầy máy_tính False	co-hypernym
tủ tủ_hồ_sơ True	hypernym
nấm_mèo khỉ_mặt_chó_tây_phi False	Random
cây_phượng cây_xanh False	co-hypernym
âm_nhạc nhạc_rock True	hypernym
bánh_đa gà_gô False	Random
chuối_ngự chuối_tiêu False	co-hypernym
chó chó_pug True	hypernym
táo cây_nông_nghiệp False	Random
cá_trích cá_tra False	co-hypernym
mũ mũ_nồi True	hypernym
ghế_điện sữa False	Random
tranh_thêu tranh_biếm_hoạ False	co-hypernym
chim đại_bàng True	hypernym
tình_cảm cây_xương_rồng False	Random
cây_táo cây_bưởi False	co-hypernym
trường_học trường_tiểu_học True	hypernym
học_hỏi đỏ False	Random
tủ_quần_áo tủ_kính_trưng_bày False	co-hypernym
nước nước_sạch True	hypernym
thịt_chó ho_gà False	Random
cá_quả cá_quả False	co-hypernym
bánh bánh_mỳ True	hypernym
rắn_nước pop False	Random
ho_gà tạp_bệnh False	co-hypernym
nước nước_suối True	hypernym
đàn bò_cái False	Random
hoa_súng hoa_ly False	co-hypernym
môn_học sinh_học True	hypernym
đèn_trần vịt_biển False	Random
áo_sơ_mi áo_phông False	co-hypernym
cá cá_chình True	hypernym
học chim_ưng False	Random
rau_dền bạc_hà False	co-hypernym
thịt ba_chỉ True	hypernym
ngoan_ngoãn tủ_âm False	Random
chim_cút chim_chóc False	co-hypernym
ghế ghế_nhựa True	hypernym
chanh chó_pug False	Random
dưa_lê mãng_cầu False	co-hypernym
máy máy_cầy True	hypernym
bắp_cải phim False	Random
đèn_điện đèn_dầu False	co-hypernym
thịt thịt_heo True	hypernym
rau_diếp tranh_màu_nước False	Random
sa_tế đường False	co-hypernym
cây_ăn_quả thanh_long True	hypernym
gà_ri thứ_ba False	Random
tủ_sách tủ_lạnh False	co-hypernym
vịt vịt_mỏ_nhọn True	hypernym
cá_trê bàn_làm_việc False	Random
rắn_ráo rắn_mai_gầm False	co-hypernym
cá cá_sấu True	hypernym
bệnh_phổi xe False	Random
cây_lạc cây_điều False	co-hypernym
chim chim_khách True	hypernym
cỏ hạt_hạnh_nhân False	Random
ghế_xếp ghế_tựa False	co-hypernym
cam cam_đường True	hypernym
viêm_não cá_biển False	Random
gà_tây gà_pha False	co-hypernym
cấp_phép cho_phép True	hypernym
đèn_giao_thông cá_trắm_đen False	Random
nhạc_giao_hưởng nhạc_đỏ False	co-hypernym
bò bò_nhà True	hypernym
cây_táo đường_phèn False	Random
hoa_hồng hoa_bằng_lăng False	co-hypernym
tranh tranh_truyện True	hypernym
đèn_chùm trả_nợ False	Random
cá_ngựa cá_biển False	co-hypernym
mưa mưa_bay True	hypernym
bệnh_mãn_tính gà_chọi False	Random
ghế_sofa ghế_cứng False	co-hypernym
âm_nhạc nhạc_nhẹ True	hypernym
ghế_matxa bệnh_phụ_nữ False	Random
tủ_đông tủ_quần_áo False	co-hypernym
lòng lòng_non True	hypernym
chổi_xể dưa_chuột False	Random
cá_nhám cá_trắm False	co-hypernym
Mưa mưa_bão True	hypernym
hoa_cúc giường_xếp False	Random
lị_nhiễm_khuẩn kiết_lị False	co-hypernym
rau_củ mướp True	hypernym
gà_chọi gà_tre False	Random
lúa_mì lúa_nước False	co-hypernym
chó chó_kiến True	hypernym
cá_nhám cây_cọ False	Random
cá_ngừ_đại_dương cá_nục False	co-hypernym
phim phim_tư_liệu True	hypernym
cá_ông măng_tây False	Random
bệnh_gan bệnh_phụ_nữ False	co-hypernym
ghế ghế_lười True	hypernym
ốc_luộc cây_bóng_mát False	Random
cải_bông_xanh dưa_chuột False	co-hypernym
cây_ăn_quả bơ True	hypernym
bò_nhà cá_bống_tượng False	Random
vú_sữa đu_đủ False	co-hypernym
đèn đèn_chùm True	hypernym
tiếng_kêu mưa_bão False	Random
tủ_đứng tủ_bảo_ôn False	co-hypernym
âm âm_vị True	hypernym
mũ_nan cam_sành False	Random
trường_trung_cấp tiểu_học False	co-hypernym
âm_nhạc nhạc_đồng_quê True	hypernym
gương_cầu_lõm sữa_bò False	Random
cá_voi cá_nước_ngọt False	co-hypernym
gà gà_pha True	hypernym
dưa_lê chó False	Random
bệnh_gan bệnh_về_máu False	co-hypernym
thịt thịt_lợn True	hypernym
ghế_dựa dưa_chuột False	Random
giấm hạt_tiêu False	co-hypernym
cây cây_cảnh True	hypernym
nước_ngọt đường_cát False	Random
cá_trê cá_cảnh False	co-hypernym
nấm nấm_kim_châm True	hypernym
hạt_hạnh_nhân tủ_chè False	Random
rau_ngót rau_đay False	co-hypernym
cá cá_thu True	hypernym
chổi_cọ sả False	Random
chuột_chù chuột_máy_tính False	co-hypernym
tranh tranh_tường True	hypernym
máy_tính_điện_tử bút_mực False	Random
mũ_nan mũ_bảo_hộ False	co-hypernym
cây cây_xương_rồng True	hypernym
hẹ cây_mít False	Random
cây_nông_nghiệp cây_điều False	co-hypernym
đèn đèn_hình True	hypernym
gà_tre nhạc_dân_tộc False	Random
ớt bột_ngọt False	co-hypernym
cấp_phép sự_uỷ_thác True	hypernym
chó_sói âm_mưu False	Random
bầu thì_là False	co-hypernym
tranh tranh_dân_gian True	hypernym
cây_nông_nghiệp quần_đùi False	Random
bầu cà_tím False	co-hypernym
ghế ghế_dù True	hypernym
rau_ngót khỉ_đuôi_ngắn False	Random
cá_sấu cá_chim False	co-hypernym
thịt thịt_chim True	hypernym
kiến_ba_khoang rau_thơm False	Random
cá_chuối cá_thu False	co-hypernym
Rau_thơm hành_lá True	hypernym
rắn danh False	Random
cây_thuốc cây_cảnh False	co-hypernym
bát bát_sắt True	hypernym
chổi_chít cải_bắp_tím False	Random
chanh tỏi False	co-hypernym
trường_học trường_trung_cấp True	hypernym
sư_tử cá_nhám False	Random
cá_quả cá_hồi False	co-hypernym
đèn đèn_lồng True	hypernym
chả_rán hoa_dơn False	Random
hoa_râm_bụt hoa_phong_lan False	co-hypernym
xe xe_thồ True	hypernym
tiếng_nhạc cây_chuối False	Random
vải dâu_tây False	co-hypernym
phong_lan hồ_điệp True	hypernym
đỏ tiếng_ồn_ào False	Random
dưa_lê nho False	co-hypernym
đèn đèn_pha True	hypernym
hạt_hạnh_nhân táo False	Random
bếp_rơm bếp_nướng False	co-hypernym
thú trăn True	hypernym
tóc_đỏ rắn_lửa False	Random
mùa_hè mùa_thu False	co-hypernym
trường_học cao_đẳng True	hypernym
bò_zebu khoa_học_tự_nhiên False	Random
dứa hồng False	co-hypernym
thuốc thuốc_hoàn_tán True	hypernym
hoa_phong_lan ôtô False	Random
ghế_xếp ghế_dài False	co-hypernym
cây_chuối chuối_hột True	hypernym
lê nguyên_âm False	Random
cây_lúa cây_cối False	co-hypernym
ghế ghế_gỗ True	hypernym
mù_tạt quần_âu False	Random
bí_đỏ đậu_bắp False	co-hypernym
hoa hoa_cẩm_chướng True	hypernym
mũ_vành chim_yến False	Random
sả hành False	co-hypernym
báo báo_lá_cải True	hypernym
rau_cải chim_ưng False	Random
hoa_hồng hoa_bưởi False	co-hypernym
đèn đèn_vàng True	hypernym
mưa_phùn hạt_sen False	Random
thịt_gà bắp_bò False	co-hypernym
giày giày_thể_thao True	hypernym
vịt gà_trống False	Random
khỉ_đuôi_ngắn khỉ_vervet False	co-hypernym
thực_phẩm trứng True	hypernym
đèn_điện gà_mái_tơ False	Random
cá_mập_trắng cá_voi False	co-hypernym
đàn đàn_bầu True	hypernym
ốc_xào thịt_chim False	Random
hoa_râm_bụt hoa_địa_lan False	co-hypernym
hoa bằng_lăng True	hypernym
rắn_cạp_nong tiếng_ồn_ào False	Random
cây_mía cây_công_nghiệp False	co-hypernym
âm bán_nguyên_âm True	hypernym
bếp_gas giày_thể_thao False	Random
cây_sung cây_lương_thực False	co-hypernym
cấp_phép sự_giao_phó True	hypernym
chất_lỏng nấm_rơm False	Random
cá_linh cá_sấu False	co-hypernym
củ củ_sắn True	hypernym
tranh_truyện cá_mập False	Random
gia_vị sữa False	co-hypernym
hoa hoa_dơn True	hypernym
mưu_toan hoa_giành_giành False	Random
cây_phi_lao cây_táo False	co-hypernym
rau_củ ngò_tây True	hypernym
phim_trinh_thám hạt_hạnh_nhân False	Random
mướp cải_bông_trắng False	co-hypernym
thịt thịt_bê True	hypernym
bóng_tenis chả_quế False	Random
cá_vàng cá_tra False	co-hypernym
đàn đàn_guitar True	hypernym
thương_yêu kẹo_dừa False	Random
đậu_bắp rau_dền False	co-hypernym
cá cá_ông True	hypernym
hồng_xiêm nhạc_nhẹ False	Random
trung_cấp đại_học False	co-hypernym
chuột chuột_cống True	hypernym
tranh_đả_kích bếp_nướng False	Random
cá_ngừ_đại_dương cá_nheo False	co-hypernym
gia_vị tỏi True	hypernym
gà_mái mưu_mô False	Random
viêm_mũi bệnh_mãn_tính False	co-hypernym
trâu trâu_nước True	hypernym
tranh_tết khổ_qua False	Random
cây_xương_rồng cây_mít False	co-hypernym
hoa hoa_mai True	hypernym
đèn danh False	Random
đậu_bắp bầu False	co-hypernym
cây cây_phượng True	hypernym
phê_chuẩn đèn_giao_thông False	Random
hoa_phượng phong_lan False	co-hypernym
chim công True	hypernym
cung mũ_phớt False	Random
bánh_dẻo bánh_bèo False	co-hypernym
cây cây_cau True	hypernym
mùi_tàu hạt_óc_chó False	Random
bánh_cáy bánh_bò False	co-hypernym
ong ong_đất True	hypernym
máy_tính_để_bàn cỏ_gà False	Random
ớt_đà_lạt sả False	co-hypernym
phim phim_truyện True	hypernym
âm rắn_mai_gầm False	Random
rắn_nước rắn_mai_gầm False	co-hypernym
mưu mưu_tính True	hypernym
cá_chim cá_sấu False	Random
tiếng_ồn_ào âm_vị False	co-hypernym
khoa_học_tự_nhiên toán_học True	hypernym
phim_tư_liệu rắn_đuôi_chuông False	Random
tranh_dân_gian tranh_biếm_hoạ False	co-hypernym
đèn đèn_trần True	hypernym
cỏ_dại tủ_đông False	Random
nước_biển vàng False	co-hypernym
xe xe_bò True	hypernym
đèn_trần gà_gô False	Random
su_hào măng False	co-hypernym
bếp bếp_lửa True	hypernym
xe_đạp khỉ_mặt_chó False	Random
bệnh_cảm_cúm bệnh_phụ_nữ False	co-hypernym
bệnh bệnh_thường_gặp True	hypernym
bếp_hồng_ngoại chôm_chôm False	Random
dâu_gia nho False	co-hypernym
tranh tranh_đả_kích True	hypernym
rock âm False	Random
cây_công_nghiệp cây_đào False	co-hypernym
rắn rắn_lục True	hypernym
áo_khoác bệnh_truyền_nhiễm_qua_không_khí False	Random
bệnh_nặng bệnh_gan False	co-hypernym
cây_ăn_quả dưa_lê True	hypernym
hoa_thược_dược trĩ False	Random
măng_cụt mãng_cầu False	co-hypernym
cây_chuối cây_chuối_pháo True	hypernym
dép_quai_hậu chuột_nhắt False	Random
ghế_nệm ghế_mềm False	co-hypernym
âm_nhạc nhạc_giao_hưởng True	hypernym
ghế_dài kính_cận False	Random
cá_cơm cá_chình False	co-hypernym
kính kính_lão True	hypernym
tủ_đứng cung_ứng False	Random
kính_lão kính_loạn False	co-hypernym
thực_phẩm rau True	hypernym
chim_bồ_câu trường_mầm_non False	Random
bơ mận False	co-hypernym
cá cá_chiên True	hypernym
đèn_hình hoa_mào_gà False	Random
dưa_chuột tỏi_tây False	co-hypernym
bếp bếp_trấu True	hypernym
lá_nốt bò_đực False	Random
cây_ăn_quả cây_chè False	co-hypernym
bánh bánh_đa True	hypernym
nước_lọc tranh_khoả_thân False	Random
cây_phi_lao cây_trồng False	co-hypernym
gà gà_mái True	hypernym
cây_chuối_pháo nhạc_vàng False	Random
đậu_hà_lan bạc_hà False	co-hypernym
bánh bánh_gai True	hypernym
dưa_hấu nước_biển False	Random
củ_đậu củ_cải False	co-hypernym
vịt vịt_bơ True	hypernym
cây_điều chó_pug False	Random
cải_bông_xanh ngò_tây False	co-hypernym
trâu nghé True	hypernym
thịt_vai chả False	Random
củ_dền thì_là False	co-hypernym
rau húng_láng True	hypernym
vật_lý tôm_hùm False	Random
đèn_hình đèn_pin False	co-hypernym
rau_củ đậu_hà_lan True	hypernym
đường_tinh_luyện nhạc_vàng False	Random
mồng_tơi nấm False	co-hypernym
thuốc thuốc_ngâm True	hypernym
dầu_ăn bóng_bàn False	Random
cây_ăn_trái cây_chè False	co-hypernym
cá cá_ngừ_đại_dương True	hypernym
máy_tính_cá_nhân bệnh False	Random
khoai_môn cà_tím False	co-hypernym
chim chim_cu_gáy True	hypernym
rắn_hổ_lửa cửa_cuốn False	Random
chim_bồ_câu chim_khuyên False	co-hypernym
đàn đàn_tranh True	hypernym
lược_thưa mưa_bay False	Random
viêm_mũi bệnh_bội_nhiễm False	co-hypernym
cấp_phép công_nhận True	hypernym
cây_dừa kẹo_mút False	Random
chó_nuôi chó_nhà False	co-hypernym
ghế ghế_điện True	hypernym
hoa_lau chó_pug False	Random
gà_tre gà_chọi False	co-hypernym
cây_ăn_quả mơ True	hypernym
tiền_tài tía_tô False	Random
tủ_đông_lạnh tủ_bảo_ôn False	co-hypernym
tranh tranh_màu_nước True	hypernym
bếp_gas bò_cái False	Random
tủ_đá tủ_chạn False	co-hypernym
khoa_học_tự_nhiên lý True	hypernym
mũ_len mưa False	Random
cây_bóng_mát cây_cỏ False	co-hypernym
tình tình_duyên True	hypernym
chả_cốm ghế_xích_đu False	Random
cá_lăng cá_chim False	co-hypernym
chim chim_bồ_nông True	hypernym
hồng_xiêm ghế_dù False	Random
cá thịt False	co-hypernym
gà gà_đồng True	hypernym
cây_dừa ghế_nệm False	Random
rắn_nước rắn_lửa False	co-hypernym
bệnh bệnh_tâm_thần True	hypernym
thì_là cây_chuối_pháo False	Random
cá_mú cá_bống False	co-hypernym
mũ mũ_phớt True	hypernym
sa_tế hoa_lan False	Random
tháng_giêng tháng_tám False	co-hypernym
chim cú_mèo True	hypernym
đèn_dầu rắn_lục False	Random
uỷ_thác phê_duyệt False	co-hypernym
chanh chanh_đào True	hypernym
âm_vị đèn_giao_thông False	Random
cải_bắp_tím ngò_tây False	co-hypernym
thực_phẩm thịt True	hypernym
bệnh_thận hoa_bằng_lăng False	Random
chổi_chít chổi_rơm False	co-hypernym
rau_củ gừng True	hypernym
cỏ bò_nhà False	Random
cá_chiên cá_chép False	co-hypernym
bánh bánh_bao True	hypernym
táo đàn_tranh False	Random
bệnh_truyền_nhiễm_qua_không_khí bệnh_lây_lan False	co-hypernym
giường giường_bệnh True	hypernym
trường_tiểu_học chim_bồ_câu False	Random
chôm_chôm chà_là False	co-hypernym
cây_ăn_quả dưa_hồng True	hypernym
đèn_ngủ tiền_polime False	Random
chim_biển chim_cánh_cụt False	co-hypernym
mũ mũ_đồng_phục True	hypernym
ghế đau_bụng False	Random
dưa_hấu mận False	co-hypernym
cây cây_lạc True	hypernym
máy_bơm tiếng_ồn False	Random
chôm_chôm dứa False	co-hypernym
hoa hoa_đào True	hypernym
cây_leo đậu_bắp False	Random
hồng_xiêm nho False	co-hypernym
mưu mưu_hại True	hypernym
tình_tứ ong False	Random
bầu hành False	co-hypernym
tàu tàu_hỏa True	hypernym
chứng_nhận chim_cú_mèo False	Random
cá_lăng cá_hồi False	co-hypernym
bánh bánh_chưng True	hypernym
tháng_một nước False	Random
viêm_mũi thương_hàn False	co-hypernym
tháng tháng_giêng True	hypernym
yêu gà False	Random
cây_chè cây_táo False	co-hypernym
bánh bánh_cáy True	hypernym
kính_áp_tròng chim_bồ_nông False	Random
hoa_mai hoa_thược_dược False	co-hypernym
âm_nhạc nhạc_dân_ca True	hypernym
đèn_điện gà_giò False	Random
đỏ xanh False	co-hypernym
cây cây_đào True	hypernym
trung_học chả_rán False	Random
hoa_sen hoa_cẩm_chướng False	co-hypernym
rau húng_chanh True	hypernym
đèn_giao_thông thương_nhớ False	Random
cá_cơm cá_mập_trắng False	co-hypernym
bệnh viêm_khí_quản True	hypernym
trường_cao_đẳng nhạc_đỏ False	Random
tủ_đông tủ_ly False	co-hypernym
âm_thanh tiếng_gõ True	hypernym
chim_cú_mèo mồng_tơi False	Random
cá_trắm cá_thu False	co-hypernym
ghế ghế_xếp True	hypernym
thương_yêu củ_sen False	Random
nước_biển lam False	co-hypernym
gà gà_gô True	hypernym
cây_đào khỉ_mặt_chó False	Random
sa_tế muối False	co-hypernym
hoa hoa_quỳnh True	hypernym
công cây_xoan False	Random
cây_mít cây_ăn_trái False	co-hypernym
rau_củ diếp_cá True	hypernym
kính_râm mũ_len False	Random
cây_bóng_mát cây_hoa False	co-hypernym
tủ tủ_đứng True	hypernym
đặc_cách bệnh_cấp_tính False	Random
cá_mập cá_ông False	co-hypernym
ghế ghế_xôpha True	hypernym
động_vật bò_biển False	Random
cá_ngựa cá_nục False	co-hypernym
thú rắn True	hypernym
chuối_mật thịt_vai False	Random
chim_chích chim_chóc False	co-hypernym
bệnh viêm_phế_quản True	hypernym
tôm_sú chim_biển False	Random
tóc_đỏ tóc_đen False	co-hypernym
rau súp_lơ True	hypernym
công tranh_minh_hoạ False	Random
cây_cà_phê cây_thông False	co-hypernym
trường_học trường_trung_học True	hypernym
cỏ thương_yêu False	Random
tủ_tường tủ_kính False	co-hypernym
cá_trắm cá_trắm_trắng True	hypernym
tháng_bảy chả_rán False	Random
súp_lơ bắp_cải False	co-hypernym
máy_tính máy_tính_để_bàn True	hypernym
tranh_sơn_mài vịt_mỏ_nhọn False	Random
hoa_tuylip hoa_hải_đường False	co-hypernym
máy_tính máy_tính_xách_tay True	hypernym
cá_nước_ngọt đau_đầu False	Random
thịt_vai thịt_cầy False	co-hypernym
đồ_đạc bàn True	hypernym
cá_da_trơn bệnh_sởi False	Random
cá_mú cá_thu False	co-hypernym
cá cá_bống_tượng True	hypernym
gương_cầu_lõm ghế_xếp False	Random
cây_bóng_mát cây_thông False	co-hypernym
hoa_hồng hồng_bạch True	hypernym
tranh_sơn_dầu bắp_cải False	Random
ghế_matxa ghế_gỗ False	co-hypernym
rau_củ dưa_chuột True	hypernym
hoa_bưởi nấm_độc False	Random
cây_ăn_quả cây_xanh False	co-hypernym
quần quần_dài True	hypernym
hoa_cau chả_cốm False	Random
quần_âu quần_đùi False	co-hypernym
cá cá_hồng True	hypernym
dấu_hai_chấm chim_chóc False	Random
đèn_trần đèn_vàng False	co-hypernym
mưa mưa_bụi True	hypernym
phim_truyện cây_ổi False	Random
chuối_mật chuối_tiêu False	co-hypernym
cá cá_linh True	hypernym
mì_chính thịt_chim False	Random
sung lê False	co-hypernym
khỉ khỉ_đầu_chó True	hypernym
cây_cau cá_chép False	Random
hoa_sen hoa_phượng False	co-hypernym
đèn đèn_huỳnh_quang True	hypernym
quạt_điện cá_trắm_cỏ False	Random
tủ_đông tủ_âm False	co-hypernym
hoa hoa_dã_quỳ True	hypernym
tôm_sú thịt_thăn False	Random
bếp_từ bếp_điện False	co-hypernym
bệnh viêm_xoang True	hypernym
dấu_hỏi gà_mái_ghẹ False	Random
rắn_nước rắn_lục False	co-hypernym
mũ mũ_len True	hypernym
tía_tô thương False	Random
cá_chình cá_heo False	co-hypernym
chuột chuột_máy_tính True	hypernym
mũ_vành mướp False	Random
tranh_minh_hoạ tranh_lụa False	co-hypernym
thuốc thuốc_bôi True	hypernym
ong nước_mắm False	Random
khỉ_đầu_chó khỉ_đuôi_ngắn False	co-hypernym
xoài xoài_cát True	hypernym
gà_giò vịt_mào False	Random
su_hào gừng False	co-hypernym
cây_ăn_quả hồng_xiêm True	hypernym
măng_cụt pop False	Random
bầu tỏi_tây False	co-hypernym
hoa oải_hương True	hypernym
cây_ăn_quả bò_nái False	Random
cây_hoa cây_trồng False	co-hypernym
cá cá_vàng True	hypernym
tâm_lý_học gà_tre False	Random
bệnh_nặng bệnh_lây_lan False	co-hypernym
thịt thịt_thăn True	hypernym
hoa_tóc_tiên chổi_chít False	Random
chó_hoang chó_nuôi False	co-hypernym
kẹo kẹo_dừa True	hypernym
tủ_sách thịt_lợn False	Random
dầu_ăn mì_chính False	co-hypernym
động_vật cá True	hypernym
hóa quần_đùi False	Random
đèn_huỳnh_quang đèn_báo_hiệu False	co-hypernym
bò bò_dái True	hypernym
bếp_lửa tỏi_tây False	Random
cải_bông_trắng khổ_qua False	co-hypernym
hoa phong_lan True	hypernym
tỏi_tây cao_đẳng False	Random
cần_nước bí_đỏ False	co-hypernym
tủ tủ_đựng_quần_áo True	hypernym
mũ_cối cây_mít False	Random
cây_hoa cây_táo False	co-hypernym
cây_ăn_quả măng_cụt True	hypernym
chim_cú_mèo rắn_cấc False	Random
su_hào tỏi False	co-hypernym
khoa_học_xã_hội văn_học True	hypernym
đèn_chùm cây_lương_thực False	Random
lị_nhiễm_khuẩn bệnh_phổi False	co-hypernym
tóc tóc_vàng True	hypernym
cây_cau mũ_cối False	Random
mì_chính bột_ngọt False	co-hypernym
cá cá_ba_sa True	hypernym
chả_rế chó_sói False	Random
phim_tài_liệu phim_truyện False	co-hypernym
rau_củ đậu_đũa True	hypernym
giường_bệnh bệnh_sởi False	Random
cá_ngừ cá_chim False	co-hypernym
cây cây_nông_nghiệp True	hypernym
quần_âu trường_trung_cấp False	Random
hoa_ly hoa_loa_kèn False	co-hypernym
học học_hành True	hypernym
tranh_ảnh_minh_hoạ mũ_bảo_hộ False	Random
rắn_nước rắn_mối False	co-hypernym
chó chó_thiến True	hypernym
bếp_điện quần_âu False	Random
cây_rau cây_táo False	co-hypernym
bò bò_nái True	hypernym
hoa_đào phim_hoạt_hình False	Random
oải_hương hoa_hồng False	co-hypernym
đau đau_lưng True	hypernym
tủ_hồ_sơ cây_bưởi False	Random
nấm rau_chân_vịt False	co-hypernym
màu_sắc chàm True	hypernym
tủ_chữa_cháy trường_trung_cấp False	Random
kiết_lị đau_dạ_dày False	co-hypernym
rắn rắn_cạp_nong True	hypernym
bệnh_truyền_nhiễm Mưa False	Random
ốc_vặn ốc_luộc False	co-hypernym
báo báo_online True	hypernym
cá_bống_tượng mũ_cối False	Random
dưa_gang vú_sữa False	co-hypernym
chổi chổi_đót True	hypernym
nấm_linh_chi ghế_dài False	Random
cây_cảnh cây_chuối False	co-hypernym
cây cây_sầu_riêng True	hypernym
nhạc_giao_hưởng cỏ_ba_lá False	Random
rắn_đuôi_chuông rắn_nước False	co-hypernym
chó chó_nuôi True	hypernym
ghế_xếp chó_thiến False	Random
hoa_đào hoa_cẩm_tú_cầu False	co-hypernym
màu_sắc da_trời True	hypernym
giường_của_bé nhạc_đỏ False	Random
sự_cho_phép phê_duyệt False	co-hypernym
hoa hoa_giấy True	hypernym
hổ cam_cao_phong False	Random
chả_quế chả_cá False	co-hypernym
tranh tranh_tết True	hypernym
dấu_chấm_phẩy gõ_kiến False	Random
cá_cơm cá_mập False	co-hypernym
chuối chuối_ngự True	hypernym
sữa_tươi giường_nằm False	Random
cây_cà_phê cây_mía False	co-hypernym
bút bút_bi True	hypernym
đèn_ngủ chó_kiến False	Random
cá_ông cá_trắm False	co-hypernym
âm_nhạc nhạc_trữ_tình True	hypernym
chả_cốm gà_thiến False	Random
cây_phi_lao cây_cối False	co-hypernym
hoa hoa_hồng True	hypernym
lược gà_hoa_mơ False	Random
cá_chình cá_ông False	co-hypernym
mũ mũ_bảo_hộ True	hypernym
nước_sạch âm False	Random
ghế_đẩu ghế_xôpha False	co-hypernym
mùa mùa_thu True	hypernym
khoai_lang gà_tơ False	Random
su_su bạc_hà False	co-hypernym
chó chó_nhà True	hypernym
gà_tre chim_biển False	Random
bò_tót bò_dái False	co-hypernym
ong ong_vàng True	hypernym
gà_mái đậu_bắp False	Random
chim_sẻ chim_khách False	co-hypernym
bò bò_tơ True	hypernym
kính_râm xu_hào False	Random
rắn_lửa rắn_giun False	co-hypernym
hoa hoa_cau True	hypernym
cá_rô_phi bò_tơ False	Random
cá_bơn cá_voi False	co-hypernym
vịt vịt_biển True	hypernym
công pop False	Random
rắn_nước rắn_gió False	co-hypernym
chả chả_giò True	hypernym
rắn_lửa học_lại False	Random
bê bò_rừng_bizon False	co-hypernym
chuột chuột_nhắt True	hypernym
cây_ổi mưu_toan False	Random
thịt_chó thịt_bê False	co-hypernym
cá cá_mè True	hypernym
đau vịt_biển False	Random
cây_thuốc cây_công_nghiệp False	co-hypernym
hoa hoa_cúc True	hypernym
trường_trung_học bánh_đa False	Random
khỉ_vervet khỉ_trán_trắng False	co-hypernym
thực_phẩm bánh True	hypernym
tủ_chè ghế_tựa False	Random
củ_dền khổ_qua False	co-hypernym
chim trĩ True	hypernym
cá_bống áo_sơ_mi False	Random
nước_ngọt nước_sạch False	co-hypernym
rau_củ cà_chua True	hypernym
hoa_oải_hương đặc_cách False	Random
tủ_đông tủ_sách False	co-hypernym
bệnh viêm_não True	hypernym
địa_lý giường_xếp False	Random
viêm_khí_quản đau_dạ_dày False	co-hypernym
kiến kiến_vàng True	hypernym
dưa_hồng tranh_đả_kích False	Random
cà_chua bầu False	co-hypernym
cây cây_xanh True	hypernym
đèn tâm_lý_học False	Random
cây_gỗ cây_điều False	co-hypernym
tiền tiền_vàng True	hypernym
hoa_tóc_tiên kính_loạn False	Random
cá_mập cá_ba_sa False	co-hypernym
chó chó_ngao True	hypernym
tương_ớt bánh_đa False	Random
khổ_qua rau_dền False	co-hypernym
rau rau_cải True	hypernym
ngoan đặc_cách False	Random
lị_nhiễm_khuẩn ốm_vặt False	co-hypernym
cây cây_cổ_thụ True	hypernym
bệnh_mãn_tính đèn_vàng False	Random
nước_lợ nước_sạch False	co-hypernym
chổi chổi_chít True	hypernym
chả_tôm hoa_tầm_xuân False	Random
hạt_sen hạt_hướng_dương False	co-hypernym
cây_ăn_quả vú_sữa True	hypernym
trường_mầm_non bán_nguyên_âm False	Random
tiếng_kêu tiếng_gõ False	co-hypernym
thú đười_ươi True	hypernym
cá_quả cây_xương_rồng False	Random
cá_quả cá_tầm False	co-hypernym
ghế ghế_đẩu True	hypernym
trường_cao_đẳng mưa_bụi False	Random
cá_tầm cá_ngừ False	co-hypernym
rau_củ lá_nốt True	hypernym
mưa rau False	Random
mồng_tơi diếp_cá False	co-hypernym
bát bát_sứ True	hypernym
quạt_điện bánh_cáy False	Random
cây_trồng cây_xanh False	co-hypernym
đèn đèn_giao_thông True	hypernym
cửa ớt_đà_lạt False	Random
khổ_qua rau_thơm False	co-hypernym
âm_nhạc nhạc_điện_tử True	hypernym
thuốc mưa False	Random
hoa_sen hoa_huệ False	co-hypernym
màu_sắc vàng True	hypernym
cung_ứng học False	Random
mắm_tôm giấm False	co-hypernym
quạt quạt_treo_tường True	hypernym
tranh_khoả_thân cà_chua False	Random
cá_bơn cá_ông False	co-hypernym
ghế ghế_cứng True	hypernym
hoa_huệ tủ_kính False	Random
cá_mè cá_nóc False	co-hypernym
chó chó_hoang True	hypernym
chim_cút bệnh_gan False	Random
gà_rừng gà_ri False	co-hypernym
rau_củ củ_cải_trắng True	hypernym
nước_biển đàn_tranh False	Random
tủ_đứng tủ_ly False	co-hypernym
rắn rắn_hổ_lửa True	hypernym
rắn trâu False	Random
cá_ngựa cá_chép False	co-hypernym
cây_ăn_quả mít True	hypernym
thương_nhớ Mưa False	Random
nấm_tử_thần nấm_rơm False	co-hypernym
Rau_thơm thì_là True	hypernym
củ_sen ong_mật False	Random
nhạc_tài_tử nhạc_pop False	co-hypernym
cây_ăn_quả vải True	hypernym
trả_nợ cá_chuối False	Random
dâu_gia dứa False	co-hypernym
màu_sắc tím True	hypernym
rắn_lửa hồng False	Random
dưa_gang dưa_hồng False	co-hypernym
chim chim_cú_mèo True	hypernym
gà_trống tiếng_lồng False	Random
nước_mặn nước_lọc False	co-hypernym
hoa hoa_loa_kèn True	hypernym
cung_phụng chuối False	Random
dâu_gia nhót False	co-hypernym
rắn rắn_độc True	hypernym
chó_hoang bò_zebu False	Random
cá_chình cá_sấu False	co-hypernym
rau_củ sả True	hypernym
bò_tót cây_sầu_riêng False	Random
cá_lăng cá_linh False	co-hypernym
rắn rắn_giun True	hypernym
dầu_ô_liu cá False	Random
cá_chuối cá_sấu False	co-hypernym
gia_vị dầu_ăn True	hypernym
củ_năng gạch_hoa False	Random
tủ_chạn tủ_bếp False	co-hypernym
bệnh bệnh_phụ_nữ True	hypernym
chổi bếp False	Random
gà_giò gà_đông_cảo False	co-hypernym
chó chó_săn True	hypernym
cá_quả đười_ươi False	Random
thương_yêu thương_nhớ False	co-hypernym
cá cá_da_trơn True	hypernym
hồng_bạch kiến_xoan False	Random
cá_lóc cá_trắm False	co-hypernym
cá cá_cảnh True	hypernym
hạt_sen đèn_cao_áp False	Random
bánh_cáy bích_qui False	co-hypernym
bệnh bệnh_da_ngoài_da True	hypernym
gà_gô sơ_ri False	Random
cá_bơn cá_mập_trắng False	co-hypernym
cá cá_bống True	hypernym
giường_cho_bé thực_phẩm False	Random
nhạc_dân_gian nhạc_dân_tộc False	co-hypernym
cấp_phép sự_cho_phép True	hypernym
nghé tháng_bảy False	Random
mận hồng False	co-hypernym
cây cây_dừa True	hypernym
bạch_hầu chuột_nhắt False	Random
cá_ngừ_đại_dương cá_trắm False	co-hypernym
giày giày_dây True	hypernym
mồng_tơi vịt_mào False	Random
mì_chính hạt_tiêu False	co-hypernym
hoa hoa_hải_đường True	hypernym
báo_nhân_dân lê False	Random
cây_thuốc cây_dừa False	co-hypernym
bàn bàn_học True	hypernym
khỉ bò_nhà False	Random
cây_lan cây_đào False	co-hypernym
giày giày_lười True	hypernym
cá_trắm_đen bèo_cái False	Random
dưa_hấu lê False	co-hypernym
bò bò_u_ấn_độ True	hypernym
rắn_độc thú False	Random
viêm_mũi bệnh_cấp_tính False	co-hypernym
ốc ốc_nướng True	hypernym
củ_hành_tây Mưa False	Random
chôm_chôm lê False	co-hypernym
tủ tủ_kính_trưng_bày True	hypernym
ghế_bành mưu_tính False	Random
sa_kê khế False	co-hypernym
hoa_hồng hồng_nhung True	hypernym
rượu lục False	Random
phong_lan hoa_oải_hương False	co-hypernym
xoài xoài_tượng True	hypernym
tủ_sách bò_cái False	Random
cải_bắp_tím tỏi_tây False	co-hypernym
khỉ khỉ_đột True	hypernym
ghế_xoay rắn_chuông False	Random
mũ_len mũ_bảo_hiểm False	co-hypernym
sữa sữa_mẹ True	hypernym
cá_quả bát_tô False	Random
tranh_đả_kích tranh_phong_cảnh False	co-hypernym
kính kính_râm True	hypernym
ghế_điện cây_điều False	Random
bò_tót bò_biển False	co-hypernym
rắn rắn_ráo True	hypernym
tương_ớt hoa_phượng False	Random
máy_gặt máy_tính False	co-hypernym
tháng tháng_sáu True	hypernym
tình_cảm thương_yêu False	Random
sự_uỷ_nhiệm phê_chuẩn False	co-hypernym
cá cá_nước_ngọt True	hypernym
bút_mực uốn_ván False	Random
cải_bắp_tím măng_tây False	co-hypernym
lược lược_mau True	hypernym
viêm_khí_quản học_hỏi False	Random
trung_cấp trường_trung_cấp False	co-hypernym
cây_ăn_quả khế True	hypernym
mũ_bảo_hiểm cá_trắm False	Random
rắn_hổ_lửa rắn_chuông False	co-hypernym
phim phim_tài_liệu True	hypernym
ghế_vải chuối_tiêu False	Random
bột_cà_ri hạt_tiêu False	co-hypernym
cây_ăn_quả hồng True	hypernym
bát_tô chó_hoang False	Random
đậu_hà_lan măng_tây False	co-hypernym
tôm tôm_he True	hypernym
rau_diếp hoa_loa_kèn False	Random
cá_tầm cá_cảnh False	co-hypernym
cây cây_ăn_trái True	hypernym
xu_hào kẹo_kéo False	Random
chả_rế chả_mực False	co-hypernym
bèo bèo_cái True	hypernym
gà_đông_cảo gạch_hoa False	Random
cây_lạc cây_ăn_trái False	co-hypernym
tủ tủ_bảo_quản True	hypernym
xe_ngựa sầu_riêng False	Random
cây_nông_nghiệp cây_ăn_trái False	co-hypernym
gà gà_rừng True	hypernym
dưa_hấu phim_hoạt_hình False	Random
cây_thuốc cây_ăn_quả False	co-hypernym
cây cây_chè True	hypernym
tiền_polime cây_ổi False	Random
tranh_sơn_mài tranh_lụa False	co-hypernym
cá cá_trích True	hypernym
lan_vũ_nữ đặc_cách False	Random
viêm_não bệnh_nặng False	co-hypernym
gia_vị gừng True	hypernym
chuột_chù tình_yêu False	Random
cá_lăng cá_cảnh False	co-hypernym
cây_ăn_quả sầu_riêng True	hypernym
tháng_giêng bệnh_nặng False	Random
bò_tót bò_nhà False	co-hypernym
tóc tóc_sâu True	hypernym
cá_bống hạt_dẻ False	Random
cá_cơm cá_trê False	co-hypernym
chả chả_cua True	hypernym
mưa chả_tôm False	Random
cây_điều cây_cỏ False	co-hypernym
cây cây_thuốc True	hypernym
giường_tàu viêm_phổi False	Random
viêm_xoang bệnh_tâm_thần False	co-hypernym
khoa_học_tự_nhiên vật_lý True	hypernym
tàu_hỏa cá_mập_trắng False	Random
ổi đu_đủ False	co-hypernym
giường giường_thờ True	hypernym
cá_thu chim_chóc False	Random
gà_trống gà_pha False	co-hypernym
tranh tranh_khắc_đồng True	hypernym
hồng_xiêm trả_thù False	Random
củ_sen tỏi_tây False	co-hypernym
cây cây_mít True	hypernym
cây_sung rắn_nước False	Random
hoa_huệ hoa_râm_bụt False	co-hypernym
rau_củ hẹ True	hypernym
hoa_súng cỏ_gà False	Random
chim_ưng gõ_kiến False	co-hypernym
nước nước_lọc True	hypernym
chim_yến ốc_xào False	Random
củ_cải_trắng su_su False	co-hypernym
bò bò_đực True	hypernym
thứ_năm thứ_tư False	Random
hoa_sen loa_kèn False	co-hypernym
ghế ghế_bành True	hypernym
thuốc ghế_sofa False	Random
cá_nheo cá_chép False	co-hypernym
bóng bóng_rổ True	hypernym
sự_uỷ_thác động_vật False	Random
vú_sữa xoài False	co-hypernym
đường đường_cát True	hypernym
nhạc_cổ_điển báo_hình False	Random
nước_mắm đường False	co-hypernym
cá cá_hồi True	hypernym
hoa_cẩm_chướng thịt_lợn False	Random
tương_ớt muối False	co-hypernym
rau_củ hành True	hypernym
đèn_chùm hoa_tóc_tiên False	Random
chả_cua chả_rế False	co-hypernym
cỏ cỏ_dại True	hypernym
đau_đầu cây_cau False	Random
hoa_lan hoa_ly False	co-hypernym
vịt vịt_mào True	hypernym
nước_mắm đười_ươi False	Random
cây_nông_nghiệp cây_keo False	co-hypernym
chim chim_bồ_câu True	hypernym
chích_bông quần False	Random
phim_trinh_thám phim_nhựa False	co-hypernym
bếp bếp_nướng True	hypernym
cá_bống_tượng gà_pha False	Random
nhạc_phẩm nhạc_jazz False	co-hypernym
động_vật chim True	hypernym
chả_cốm kiết_lị False	Random
cây_phượng cây_sầu_riêng False	co-hypernym
cây cây_bụi True	hypernym
củ_năng mũ_đồng_phục False	Random
tủ_đứng tủ_tường False	co-hypernym
hoa hoa_cẩm_tú_cầu True	hypernym
chuột_máy_tính yêu False	Random
cây_leo cây_rau False	co-hypernym
chổi chổi_rơm True	hypernym
nước_lợ ốc False	Random
tủ_chạn tủ_bảo_hiểm False	co-hypernym
gà gà_thiến True	hypernym
cần_nước chổi_xể False	Random
cây_sầu_riêng cây_hoa False	co-hypernym
củ củ_khoai True	hypernym
bò_dái thứ_tư False	Random
tranh_đả_kích tranh_màu_nước False	co-hypernym
âm_nhạc rock True	hypernym
tủ_đựng_quần_áo sữa_mẹ False	Random
cây_phượng cây_chuối False	co-hypernym
mũ mũ_cói True	hypernym
ghế_nệm cá_đuối False	Random
củ_khoai củ_đậu False	co-hypernym
trường_học mầm_non True	hypernym
cây_ăn_quả mận False	Random
mưa_rào mưa_phùn False	co-hypernym
cấp_phép uỷ_thác True	hypernym
cá_trắm_đen chổi False	Random
tủ_đông tủ_bảo_ôn False	co-hypernym
cây cây_công_nghiệp True	hypernym
phim_tư_liệu rắn_mối False	Random
tranh_minh_hoạ tranh_khắc_gỗ False	co-hypernym
vịt vịt_trời True	hypernym
gà_tây bò_sữa False	Random
cây_gỗ cây_thông False	co-hypernym
rau_củ rau_dền True	hypernym
ốc_mít gà_tre False	Random
nhạc_dân_gian nhạc_trữ_tình False	co-hypernym
xe xe_máy True	hypernym
phim_tâm_lý mưa False	Random
hoa_huệ hoa_mào_gà False	co-hypernym
cây_ăn_quả dưa_hấu True	hypernym
mũ_lưỡi_trai Mưa False	Random
cây_sầu_riêng cây_cọ False	co-hypernym
bò bò_sữa True	hypernym
mưa_bay tiếng_kêu False	Random
cây_lan cây_lương_thực False	co-hypernym
áo áo_phông True	hypernym
hạt_tiêu mũ_đồng_phục False	Random
khỉ_độc khỉ_mặt_chó_tây_phi False	co-hypernym
bệnh bệnh_cấp_tính True	hypernym
thứ_tư bệnh False	Random
cá_ba_sa cá_sấu False	co-hypernym
chất_lỏng nước True	hypernym
dừa bích_qui False	Random
hành_tây súp_lơ False	co-hypernym
dấu dấu_sắc True	hypernym
tủ_bếp tạp_bệnh False	Random
củ_hành_tây khoai_môn False	co-hypernym
đèn đèn_báo_hiệu True	hypernym
đàn_tranh tháng_chạp False	Random
bầu bạc_hà False	co-hypernym
Cá cá_rô True	hypernym
cỏ cá_da_trơn False	Random
cải_bắp_tím hẹ False	co-hypernym
bệnh ốm_vặt True	hypernym
học_lại nấm_rơm False	Random
cải_bông_xanh gừng False	co-hypernym
phim phim_tâm_lý True	hypernym
quần_dài nước False	Random
cải_bông_xanh măng_tây False	co-hypernym
chim chim_chích True	hypernym
đàn_piano chim_cu_gáy False	Random
cây_thông cây_ăn_quả False	co-hypernym
phương_tiện_có_bánh xích_lô True	hypernym
tranh_khắc_đồng mưa_đá False	Random
củ_năng hành False	co-hypernym
cá cá_lăng True	hypernym
bạch_hầu bò_mộng False	Random
chim_sẻ chim_bồ_câu False	co-hypernym
tranh tranh_thuỷ_mạc True	hypernym
chôm_chôm cá_nục False	Random
bằng_lăng hoa_oải_hương False	co-hypernym
cá cá_ngừ True	hypernym
chuối_hột kính_lão False	Random
củ_năng rau_muống False	co-hypernym
cây_ăn_quả dâu_gia True	hypernym
tôm_càng_xanh rau_muống False	Random
hoa_sen hoa_oải_hương False	co-hypernym
gà gà_ác True	hypernym
chả_rán dấu_hỏi False	Random
đèn_điện đèn_pha False	co-hypernym
tủ tủ_đông_lạnh True	hypernym
cá_trắm_trắng chuột False	Random
cây_nhãn cây_bưởi False	co-hypernym
cây cây_lương_thực True	hypernym
nước_mặn tóc_đỏ False	Random
học_lại học_hành False	co-hypernym
tôm tôm_thẻ_chân_trắng True	hypernym
chim_cánh_cụt bánh_dẻo False	Random
đèn_giao_thông đèn_cao_áp False	co-hypernym
rắn rắn_cấc True	hypernym
cỏ báo_lá_cải False	Random
máy_rửa_bát máy_gặt False	co-hypernym
cây cây_lúa True	hypernym
bếp_củi đàn False	Random
mũ_len mũ_nồi False	co-hypernym
cấp_phép chứng_nhận True	hypernym
phim_truyền_hình bánh_chưng False	Random
cần_nước cà_tím False	co-hypernym
quần quần_âu True	hypernym
chổi_cọ ghế_dựa False	Random
cá_nóc cá_trắm False	co-hypernym
chả chả_mực True	hypernym
dâu_tây giường_cho_bé False	Random
tỏi_tây ngò_tây False	co-hypernym
dấu dấu_hỏi True	hypernym
cá_chình lý False	Random
hoa_tầm_xuân hoa_dơn False	co-hypernym
khoa_học_tự_nhiên hóa True	hypernym
bò_tót bệnh_cảm_cúm False	Random
tủ_bảo_hiểm tủ_buffet False	co-hypernym
ong ong_mật True	hypernym
rắn_nước chả_cua False	Random
chích_bông vẹt False	co-hypernym
thú báo True	hypernym
bếp_lò sự_giao_phó False	Random
phim_tài_liệu phim_trinh_thám False	co-hypernym
tủ tủ_tài_liệu True	hypernym
vịt_mỏ_nhọn cần_tây False	Random
chim_câu vẹt False	co-hypernym
chuột chuột_chù True	hypernym
khỉ_độc nước_ngọt False	Random
dưa_hấu đào False	co-hypernym
rau_củ rau_muống True	hypernym
dưa_lê ban_đặc_quyền False	Random
hoa_đồng_tiền hoa_loa_kèn False	co-hypernym
bệnh viêm_mũi True	hypernym
phim_truyện sầu_riêng False	Random
rắn_giun rắn_cạp_nong False	co-hypernym
cấp_phép thừa_nhận True	hypernym
mưu_tính mưa False	Random
nhãn dứa False	co-hypernym
thịt thịt_gà True	hypernym
vịt_lưỡi_liềm hoa_bách_hợp False	Random
cá_lăng cá_chình False	co-hypernym
cây cây_hoa True	hypernym
báo_lá_cải tóc_vàng False	Random
chim_hồng_hạc chào_mào False	co-hypernym
cây cây_sung True	hypernym
súp_lơ_xanh tôm_hùm False	Random
rắn_hổ_lửa rắn_gió False	co-hypernym
tháng tháng_năm True	hypernym
cam_chua trĩ False	Random
mít chôm_chôm False	co-hypernym
rau_củ tỏi_tây True	hypernym
mũ_phớt Cá False	Random
nhạc_sống nhạc_trữ_tình False	co-hypernym
hoa hoa_phượng True	hypernym
dấu_hai_chấm uốn_ván False	Random
đèn_hình đèn_flash False	co-hypernym
gà gà_ri True	hypernym
Rau_thơm mướp False	Random
cây_thông cây_chuối False	co-hypernym
chim chim_kền_kền True	hypernym
thứ_ba trường_cao_đẳng False	Random
cá_mú cá_nhám False	co-hypernym
khoa_học khoa_học_tự_nhiên True	hypernym
táo_mèo ghế_nhựa False	Random
cá_cảnh cá_thu False	co-hypernym
khoa_học khoa_học_xã_hội True	hypernym
tranh_truyện mưa False	Random
tranh_tết tranh_màu_nước False	co-hypernym
toán_học đại_số True	hypernym
trường_đại_học bò_đực False	Random
ong_bò_vẽ ong_mật False	co-hypernym
toán_học giải_tích True	hypernym
dấu_chấm nước_khoáng False	Random
giấm muối False	co-hypernym
toán_học hình_học True	hypernym
hoa_cúc trung_học False	Random
hoa_bằng_lăng hoa_râm_bụt False	co-hypernym
văn_học thơ True	hypernym
táo_đường cam_vinh False	Random
củ_hành_tây giá False	co-hypernym
văn_học tiểu_thuyết True	hypernym
kẹo khỉ_đột False	Random
cá_hồng cá_vàng False	co-hypernym
văn_học truyện_ngắn True	hypernym
súp_lơ_xanh thịt_vai False	Random
cây_sầu_riêng cây_thuốc False	co-hypernym
hóa_học hóa_vô_cơ True	hypernym
kiến_ba_khoang măng_cụt False	Random
cá_rô_phi cá_cảnh False	co-hypernym
hóa_học hóa_hữu_cơ True	hypernym
bơ rau_diếp False	Random
hoa_ban hoa_mai False	co-hypernym
toán_học toán_rời_rạc True	hypernym
dầu_ô_liu uỷ_thác False	Random
cây_bóng_mát cây_chè False	co-hypernym
điện điện_gió True	hypernym
ghế_sofa cây_thuốc False	Random
dưa_lê măng_cụt False	co-hypernym
điện nhiệt_điện True	hypernym
ngoan_hiền tủ_tường False	Random
cây_chè cây_cảnh False	co-hypernym
điện điện_hạt_nhân True	hypernym
tóc_bạc dưa_lê False	Random
đậu_bắp cải_bông_trắng False	co-hypernym
máy_tính máy_vi_tính True	hypernym
nấm_sò kính_râm False	Random
tranh_tết tranh_thuỷ_mạc False	co-hypernym
máy_tính máy_chủ True	hypernym
dưa_gang gà_tam_hoàng False	Random
hoa_hồng hoa_hải_đường False	co-hypernym
sách sách_giáo_khoa True	hypernym
bò_bizon hẹ False	Random
cây_lâu_năm cây_thuốc False	co-hypernym
điện_thoại điện_thoại_bàn True	hypernym
mùa_đông củ_năng False	Random
bệnh_thận bệnh_truyền_nhiễm_qua_không_khí False	co-hypernym
điện_thoại điện_thoại_di_động True	hypernym
mũ_phớt cam False	Random
nhạc_sống nhạc_pop False	co-hypernym
thể_thao bóng_đá True	hypernym
bò_nhà áo_sơ_mi False	Random
sư_tử voi False	co-hypernym
thể_thao cầu_lông True	hypernym
cải_bắp_tím đau_bụng False	Random
đậu_hà_lan dưa_chuột False	co-hypernym
thể_thao bơi_lội True	hypernym
đau_đầu giày_dây False	Random
hoa_mào_gà hoa_thược_dược False	co-hypernym
thể_thao bóng_chuyền True	hypernym
củ_đậu trâu_nước False	Random
cây_đào cây_chè False	co-hypernym
thể_thao điền_kinh True	hypernym
đèn_dầu cây_điều False	Random
gà_sống gà_rừng False	co-hypernym
